Rk,Player,Pos,Age,Tm,G,GS,MP,FG,FGA,FG%,3P,3PA,3P%,2P,2PA,2P%,eFG%,FT,FTA,FT%,ORB,DRB,TRB,AST,STL,BLK,TOV,PF,PTS
1,Precious Achiuwa\achiupr01,PF,21,MIA,16,2,257,46,73,.630,0,0,,46,73,.630,.630,25,46,.543,28,51,79,13,5,8,21,38,117
2,Jaylen Adams\adamsja01,PG,24,MIL,1,0,1,0,1,.000,0,1,.000,0,0,,.000,0,0,,0,0,0,0,0,0,0,0,0
3,Steven Adams\adamsst01,C,27,NOP,15,15,451,60,97,.619,0,0,,60,97,.619,.619,20,39,.513,58,78,136,39,16,10,31,28,140
4,Bam Adebayo\adebaba01,C,23,MIA,14,14,453,105,173,.607,2,3,.667,103,170,.606,.613,78,91,.857,23,103,126,76,11,13,46,37,290
5,LaMarcus Aldridge\aldrila01,C,35,SAS,14,14,385,88,193,.456,16,54,.296,72,139,.518,.497,11,13,.846,12,54,66,28,6,12,15,24,203
6,Ty-Shon Alexander\alexaty01,SG,22,PHO,3,0,8,0,3,.000,0,1,.000,0,2,.000,.000,0,0,,0,1,1,1,0,0,0,1,0
7,Nickeil Alexander-Walker\alexani01,SG,22,NOP,13,3,260,54,119,.454,17,51,.333,37,68,.544,.525,18,23,.783,3,34,37,24,12,2,21,27,143
8,Grayson Allen\allengr01,SG,25,MEM,12,4,258,27,72,.375,18,50,.360,9,22,.409,.500,24,27,.889,6,29,35,24,12,3,14,10,96
9,Jarrett Allen\allenja01,C,22,TOT,16,5,425,64,94,.681,0,0,,64,94,.681,.681,55,71,.775,49,105,154,24,8,26,27,27,183
9,Jarrett Allen\allenja01,C,22,BRK,12,5,320,44,65,.677,0,0,,44,65,.677,.677,46,61,.754,38,87,125,20,7,19,22,21,134
9,Jarrett Allen\allenja01,C,22,CLE,4,0,105,20,29,.690,0,0,,20,29,.690,.690,9,10,.900,11,18,29,4,1,7,5,6,49
10,Kyle Anderson\anderky01,PF,27,MEM,13,13,386,60,143,.420,19,57,.333,41,86,.477,.486,24,30,.800,13,81,94,53,8,10,24,26,163
11,Giannis Antetokounmpo\antetgi01,PF,26,MIL,15,15,485,149,273,.546,21,70,.300,128,203,.631,.584,86,147,.585,26,132,158,80,16,16,59,52,405
12,Kostas Antetokounmpo\antetko01,PF,23,LAL,1,0,8,0,2,.000,0,0,,0,2,.000,.000,0,0,,0,4,4,0,0,2,2,1,0
13,Thanasis Antetokounmpo\antetth01,SF,28,MIL,13,0,130,15,23,.652,2,7,.286,13,16,.813,.696,2,3,.667,12,13,25,12,3,2,13,23,34
14,Carmelo Anthony\anthoca01,PF,36,POR,15,1,385,63,161,.391,26,68,.382,37,93,.398,.472,40,47,.851,4,46,50,18,14,11,11,32,192
15,Cole Anthony\anthoco01,PG,20,ORL,18,10,468,72,195,.369,21,62,.339,51,133,.383,.423,33,39,.846,16,66,82,60,12,7,31,39,198
16,OG Anunoby\anunoog01,SF,23,TOR,17,17,592,86,177,.486,42,97,.433,44,80,.550,.605,35,47,.745,27,72,99,27,35,9,30,49,249
17,Ryan Arcidiacono\arcidry01,PG,26,CHI,5,0,65,8,20,.400,6,13,.462,2,7,.286,.550,4,5,.800,0,12,12,12,2,0,2,7,26
18,D.J. Augustin\augusdj01,PG,33,MIL,15,0,274,27,78,.346,18,47,.383,9,31,.290,.462,16,16,1.000,7,12,19,40,7,0,14,6,88
19,Deni Avdija\avdijde01,SF,20,WAS,11,11,255,28,62,.452,16,35,.457,12,27,.444,.581,5,8,.625,4,40,44,24,11,3,7,29,77
20,Deandre Ayton\aytonde01,C,22,PHO,15,15,477,96,162,.593,2,9,.222,94,153,.614,.599,31,42,.738,50,133,183,28,5,19,28,51,225
21,Udoka Azubuike\azubuud01,C,21,UTA,9,0,44,4,7,.571,0,0,,4,7,.571,.571,4,6,.667,4,7,11,0,1,3,3,7,12
22,Dwayne Bacon\bacondw01,SG,25,ORL,18,14,432,69,163,.423,11,39,.282,58,124,.468,.457,17,24,.708,6,47,53,16,8,2,14,33,166
23,Marvin Bagley III\baglema01,PF,21,SAC,16,16,427,84,181,.464,15,43,.349,69,138,.500,.506,29,51,.569,34,94,128,14,6,10,25,43,212
24,LaMelo Ball\ballla01,PG,19,CHO,17,0,418,73,182,.401,24,77,.312,49,105,.467,.467,22,33,.667,25,78,103,100,24,7,42,43,192
25,Lonzo Ball\balllo01,PG,23,NOP,12,12,381,56,144,.389,25,86,.291,31,58,.534,.476,7,12,.583,5,40,45,56,15,7,30,33,144
26,Mo Bamba\bambamo01,C,22,ORL,4,0,33,8,18,.444,2,7,.286,6,11,.545,.500,2,3,.667,5,9,14,2,0,2,2,10,20
27,Desmond Bane\banede01,SG,22,MEM,13,0,285,41,87,.471,23,47,.489,18,40,.450,.603,7,9,.778,5,31,36,14,9,0,14,24,112
28,Harrison Barnes\barneha02,PF,28,SAC,16,16,558,85,178,.478,23,59,.390,62,119,.521,.542,62,74,.838,13,89,102,54,12,3,22,17,255
29,RJ Barrett\barrerj01,SG,20,NYK,18,18,651,116,281,.413,18,72,.250,98,209,.469,.445,64,84,.762,28,99,127,61,12,5,33,43,314
30,Will Barton\bartowi01,SF,30,DEN,17,13,481,68,168,.405,23,66,.348,45,102,.441,.473,25,34,.735,9,63,72,53,16,9,21,28,184
31,Keita Bates-Diop\bateske01,SF,25,SAS,3,0,5,0,2,.000,0,0,,0,2,.000,.000,0,0,,0,0,0,1,0,0,0,0,0
32,Nicolas Batum\batumni01,SF,32,LAC,17,17,490,58,115,.504,34,75,.453,24,40,.600,.652,20,23,.870,17,65,82,42,22,6,11,35,170
33,Aron Baynes\baynear01,C,34,TOR,14,14,227,29,75,.387,8,31,.258,21,44,.477,.440,0,0,,19,48,67,9,3,4,10,31,66
34,Kent Bazemore\bazemke01,SF,31,GSW,15,0,228,28,55,.509,11,24,.458,17,31,.548,.609,9,13,.692,4,36,40,26,10,9,16,27,76
35,Darius Bazley\bazleda01,PF,20,OKC,16,16,470,65,163,.399,23,78,.295,42,85,.494,.469,20,27,.741,11,104,115,23,7,14,29,18,173
36,Bradley Beal\bealbr01,SG,27,WAS,11,11,392,134,274,.489,27,74,.365,107,200,.535,.538,85,98,.867,16,44,60,54,14,7,37,27,380
37,Malik Beasley\beaslma01,SG,24,MIN,16,16,511,115,258,.446,44,117,.376,71,141,.504,.531,39,43,.907,11,67,78,37,11,4,22,22,313
38,Jordan Bell\belljo01,C,26,WAS,1,0,3,1,1,1.000,0,0,,1,1,1.000,1.000,0,0,,0,1,1,0,0,1,0,0,2
39,DeAndre' Bembry\bembrde01,SF,26,TOR,9,0,49,5,10,.500,0,1,.000,5,9,.556,.500,0,0,,3,5,8,6,3,2,7,4,10
40,Dāvis Bertāns\bertada01,PF,28,WAS,11,0,264,38,102,.373,31,86,.360,7,16,.438,.525,23,28,.821,6,28,34,15,6,3,6,23,130
41,Patrick Beverley\beverpa01,PG,32,LAC,16,16,410,42,105,.400,29,70,.414,13,35,.371,.538,16,21,.762,20,51,71,34,16,12,12,56,129
42,Saddiq Bey\beysa01,SF,21,DET,16,4,296,37,106,.349,28,74,.378,9,32,.281,.481,20,25,.800,6,47,53,9,7,0,11,23,122
43,Tyler Bey\beyty01,SF,22,DAL,4,0,13,2,5,.400,0,0,,2,5,.400,.400,2,4,.500,2,1,3,0,0,1,0,2,6
44,Khem Birch\birchkh01,C,28,ORL,18,0,398,46,94,.489,1,6,.167,45,88,.511,.495,34,42,.810,49,63,112,22,16,8,10,31,127
45,Goga Bitadze\bitadgo01,C,21,IND,3,0,28,5,10,.500,0,2,.000,5,8,.625,.500,5,6,.833,1,3,4,0,2,3,1,4,15
46,Bismack Biyombo\biyombi01,C,28,CHO,17,16,456,51,92,.554,0,1,.000,51,91,.560,.554,19,42,.452,46,78,124,30,5,22,21,47,121
47,Nemanja Bjelica\bjeline01,PF,32,SAC,10,0,151,21,51,.412,5,21,.238,16,30,.533,.461,19,23,.826,10,26,36,19,0,2,12,20,66
48,Eric Bledsoe\bledser01,SG,31,NOP,14,13,406,67,152,.441,26,64,.406,41,88,.466,.526,19,28,.679,8,43,51,50,14,4,27,24,179
49,Keljin Blevins\blevike01,SF,25,POR,5,0,24,1,6,.167,0,3,.000,1,3,.333,.167,0,0,,0,0,0,4,1,0,3,3,2
50,Bogdan Bogdanović\bogdabo01,SG,28,ATL,9,2,213,30,78,.385,21,58,.362,9,20,.450,.519,8,9,.889,2,32,34,19,4,1,11,18,89
51,Bojan Bogdanović\bogdabo02,SF,31,UTA,16,16,478,72,191,.377,40,107,.374,32,84,.381,.482,32,39,.821,10,53,63,34,6,1,25,25,216
52,Bol Bol\bolbo01,PF,21,DEN,8,2,52,6,15,.400,2,6,.333,4,9,.444,.467,0,0,,0,6,6,1,0,3,5,7,14
53,Marques Bolden\boldema01,C,22,CLE,6,0,29,1,3,.333,0,0,,1,3,.333,.333,5,8,.625,3,3,6,0,2,2,2,0,7
54,Jordan Bone\bonejo01,PG,23,ORL,10,0,167,21,43,.488,8,24,.333,13,19,.684,.581,0,0,,3,18,21,12,2,0,3,9,50
55,Isaac Bonga\bongais01,SF,21,WAS,9,5,127,12,24,.500,7,14,.500,5,10,.500,.646,0,1,.000,7,18,25,7,3,4,3,16,31
56,Devin Booker\bookede01,SG,24,PHO,14,14,500,115,243,.473,29,85,.341,86,158,.544,.533,61,74,.824,3,46,49,58,15,6,58,45,320
57,Chris Boucher\bouchch01,C,28,TOR,17,0,403,86,157,.548,29,64,.453,57,93,.613,.640,42,55,.764,36,77,113,19,11,38,14,46,243
58,Brian Bowen\bowenbr02,SF,22,IND,1,0,5,1,2,.500,0,0,,1,2,.500,.500,1,1,1.000,0,1,1,0,0,0,0,0,3
59,Avery Bradley\bradlav01,SG,30,MIA,7,1,160,25,51,.490,13,29,.448,12,22,.545,.618,7,9,.778,1,12,13,12,6,1,5,18,70
60,Tony Bradley\bradlto01,C,23,PHI,6,0,90,16,30,.533,0,1,.000,16,29,.552,.533,3,5,.600,18,24,42,3,3,6,1,8,35
61,Jarrell Brantley\brantja01,PF,24,UTA,2,0,7,0,1,.000,0,1,.000,0,0,,.000,0,0,,1,0,1,0,0,1,0,2,0
62,Ignas Brazdeikis\brazdig01,SF,22,NYK,4,0,7,0,1,.000,0,0,,0,1,.000,.000,2,2,1.000,1,1,2,1,0,0,1,0,2
63,Mikal Bridges\bridgmi01,SF,24,PHO,15,15,501,78,153,.510,39,85,.459,39,68,.574,.637,31,38,.816,22,65,87,27,9,17,8,31,226
64,Miles Bridges\bridgmi02,PF,22,CHO,17,0,435,60,129,.465,22,58,.379,38,71,.535,.550,18,19,.947,18,71,89,30,14,15,30,39,160
65,Malcolm Brogdon\brogdma01,PG,28,IND,17,17,626,142,312,.455,48,119,.403,94,193,.487,.532,54,60,.900,10,60,70,122,26,3,35,34,386
66,Dillon Brooks\brookdi01,SF,25,MEM,13,13,380,76,206,.369,25,82,.305,51,124,.411,.430,20,26,.769,17,34,51,40,18,5,32,46,197
67,Bruce Brown\brownbr01,PG,24,BRK,15,6,242,35,65,.538,3,16,.188,32,49,.653,.562,6,9,.667,17,47,64,13,6,6,15,24,79
68,Jaylen Brown\brownja02,SG,24,BOS,16,16,521,167,316,.528,42,96,.438,125,220,.568,.595,60,78,.769,19,73,92,55,24,8,43,42,436
69,Moses Brown\brownmo01,C,21,OKC,5,0,22,5,7,.714,0,0,,5,7,.714,.714,7,14,.500,2,8,10,1,1,2,0,3,17
70,Sterling Brown\brownst02,SG,25,HOU,13,1,270,41,80,.513,21,45,.467,20,35,.571,.644,4,4,1.000,12,32,44,17,13,1,6,24,107
71,Troy Brown Jr.\browntr01,SF,21,WAS,7,0,123,13,30,.433,6,18,.333,7,12,.583,.533,0,3,.000,5,17,22,8,2,1,5,14,32
72,Jalen Brunson\brunsja01,PG,24,DAL,13,6,307,56,107,.523,15,35,.429,41,72,.569,.593,31,34,.912,1,32,33,46,6,0,22,19,158
73,Thomas Bryant\bryanth01,C,23,WAS,10,10,271,59,91,.648,9,21,.429,50,70,.714,.698,16,24,.667,18,43,61,15,4,8,11,31,143
74,Reggie Bullock\bullore01,SF,29,NYK,15,15,414,47,122,.385,24,69,.348,23,53,.434,.484,7,10,.700,5,57,62,19,11,2,12,39,125
75,Trey Burke\burketr01,PG,28,DAL,16,0,362,64,143,.448,30,73,.411,34,70,.486,.552,21,25,.840,4,18,22,28,16,2,12,32,179
76,Alec Burks\burksal01,SG,29,NYK,6,1,168,28,63,.444,17,31,.548,11,32,.344,.579,27,34,.794,1,24,25,15,6,4,11,15,100
77,Jimmy Butler\butleji01,SF,31,MIA,6,6,174,34,77,.442,0,7,.000,34,70,.486,.442,27,29,.931,10,23,33,32,13,4,11,4,95
78,Bruno Caboclo\cabocbr01,PF,25,HOU,6,0,36,8,17,.471,0,5,.000,8,12,.667,.471,1,2,.500,3,11,14,1,0,2,4,6,17
79,Kentavious Caldwell-Pope\caldwke01,SG,27,LAL,14,14,331,51,98,.520,31,62,.500,20,36,.556,.679,16,18,.889,6,25,31,19,13,4,12,24,149
80,Facundo Campazzo\campafa01,PG,29,DEN,16,0,199,19,51,.373,14,36,.389,5,15,.333,.510,10,13,.769,3,10,13,23,11,1,12,31,62
81,Vlatko Čančar\cancavl01,PF,23,DEN,5,0,14,0,3,.000,0,2,.000,0,1,.000,.000,0,0,,1,2,3,0,2,1,2,1,0
82,Clint Capela\capelca01,C,26,ATL,13,13,383,78,137,.569,0,0,,78,137,.569,.569,28,51,.549,59,130,189,14,10,30,16,24,184
83,Vernon Carey Jr.\careyve01,C,19,CHO,3,0,6,1,3,.333,0,1,.000,1,2,.500,.333,1,2,.500,2,1,3,1,0,1,0,0,3
84,Jevon Carter\carteje01,PG,25,PHO,15,0,195,22,58,.379,11,40,.275,11,18,.611,.474,2,2,1.000,1,22,23,13,8,5,3,24,57
85,Wendell Carter Jr.\cartewe01,C,21,CHI,14,14,377,65,122,.533,4,15,.267,61,107,.570,.549,45,62,.726,33,79,112,34,9,9,27,43,179
86,Michael Carter-Williams\cartemi01,SG,29,ORL,7,2,160,15,44,.341,1,12,.083,14,32,.438,.352,5,6,.833,15,21,36,12,4,4,9,19,36
87,Alex Caruso\carusal01,PG,26,LAL,13,0,231,24,54,.444,18,33,.545,6,21,.286,.611,3,4,.750,5,26,31,29,15,3,14,17,69
88,Willie Cauley-Stein\caulewi01,C,27,DAL,17,9,329,42,72,.583,0,2,.000,42,70,.600,.583,22,38,.579,25,65,90,15,8,11,11,48,106
89,Chris Chiozza\chiozch01,PG,25,BRK,7,0,85,10,37,.270,4,15,.267,6,22,.273,.324,5,7,.714,3,5,8,19,4,3,6,5,29
90,Marquese Chriss\chrisma01,PF,23,GSW,2,0,27,5,14,.357,1,5,.200,4,9,.444,.393,2,4,.500,3,10,13,2,0,2,2,3,13
91,Gary Clark\clarkga01,SF,26,ORL,15,3,297,18,55,.327,13,45,.289,5,10,.500,.445,6,7,.857,17,40,57,8,5,3,11,16,55
92,Brandon Clarke\clarkbr01,PF,24,MEM,13,9,381,76,162,.469,7,27,.259,69,135,.511,.491,13,26,.500,27,53,80,24,14,9,10,22,172
93,Jordan Clarkson\clarkjo01,SG,28,UTA,16,0,397,104,214,.486,47,115,.409,57,99,.576,.596,24,25,.960,15,56,71,30,16,4,30,22,279
94,Amir Coffey\coffeam01,SG,23,LAC,11,0,53,7,17,.412,3,7,.429,4,10,.400,.500,2,5,.400,2,2,4,4,0,0,1,3,19
95,John Collins\collijo01,PF,23,ATL,16,16,482,105,195,.538,21,52,.404,84,143,.587,.592,37,46,.804,36,83,119,26,9,15,21,53,268
96,Mike Conley\conlemi01,PG,33,UTA,16,16,478,93,201,.463,46,109,.422,47,92,.511,.577,30,42,.714,16,43,59,95,25,2,35,34,262
97,Pat Connaughton\connapa01,SG,28,MIL,13,0,227,26,60,.433,19,42,.452,7,18,.389,.592,4,4,1.000,15,38,53,20,10,5,3,17,75
98,Quinn Cook\cookqu01,PG,27,LAL,11,0,40,8,16,.500,4,8,.500,4,8,.500,.625,4,5,.800,0,3,3,3,1,0,1,1,24
99,DeMarcus Cousins\couside01,C,30,HOU,12,3,205,30,95,.316,13,46,.283,17,49,.347,.384,22,29,.759,16,75,91,32,6,11,23,30,95
100,Robert Covington\covinro01,PF,30,POR,15,15,450,33,109,.303,22,79,.278,11,30,.367,.404,9,10,.900,8,75,83,26,21,9,17,43,97
101,Torrey Craig\craigto01,SF,30,MIL,3,0,26,2,4,.500,0,1,.000,2,3,.667,.500,0,0,,1,5,6,4,1,1,1,4,4
102,Jae Crowder\crowdja01,PF,30,PHO,15,12,434,50,131,.382,36,104,.346,14,27,.519,.519,18,21,.857,4,65,69,35,14,1,11,35,154
103,Jarrett Culver\culveja01,SG,21,MIN,16,7,339,51,111,.459,8,31,.258,43,80,.538,.495,20,33,.606,25,55,80,15,11,6,21,38,130
104,Seth Curry\curryse01,SG,30,PHI,11,11,317,61,109,.560,29,54,.537,32,55,.582,.693,21,21,1.000,2,21,23,33,10,3,16,20,172
105,Stephen Curry\curryst01,PG,32,GSW,17,17,576,157,343,.458,74,189,.392,83,154,.539,.566,95,103,.922,11,82,93,102,22,2,57,38,483
106,Anthony Davis\davisan02,PF,27,LAL,16,16,522,135,258,.523,15,43,.349,120,215,.558,.552,64,87,.736,30,112,142,57,22,31,28,27,349
107,Ed Davis\davised01,C,31,MIN,13,4,182,13,32,.406,0,0,,13,32,.406,.406,5,6,.833,32,41,73,14,7,6,3,33,31
108,Terence Davis\daviste02,SG,23,TOR,12,0,147,33,69,.478,16,39,.410,17,30,.567,.594,5,5,1.000,2,16,18,11,7,2,16,20,87
109,DeMar DeRozan\derozde01,SF,31,SAS,15,15,507,99,216,.458,9,29,.310,90,187,.481,.479,94,106,.887,12,68,80,102,16,8,25,34,301
110,Hamidou Diallo\diallha01,SG,22,OKC,16,0,324,70,131,.534,5,17,.294,65,114,.570,.553,34,59,.576,14,61,75,30,17,4,19,35,179
111,Gorgui Dieng\dienggo01,C,31,MEM,10,0,168,31,59,.525,11,25,.440,20,34,.588,.619,8,8,1.000,11,33,44,16,10,6,10,14,81
112,Spencer Dinwiddie\dinwisp01,SG,27,BRK,3,3,64,6,16,.375,2,7,.286,4,9,.444,.438,6,6,1.000,0,13,13,9,2,1,5,4,20
113,Donte DiVincenzo\divindo01,SG,24,MIL,16,16,407,61,136,.449,33,77,.429,28,59,.475,.570,6,8,.750,15,52,67,42,21,3,20,18,161
114,Luka Dončić\doncilu01,PG,21,DAL,16,16,557,154,336,.458,33,116,.284,121,220,.550,.507,95,124,.766,18,138,156,159,17,12,64,28,436
115,Luguentz Dort\dortlu01,SG,21,OKC,16,16,460,72,154,.468,35,88,.398,37,66,.561,.581,25,33,.758,11,47,58,19,16,5,19,42,204
116,Damyean Dotson\dotsoda01,SG,26,CLE,16,6,386,53,128,.414,21,70,.300,32,58,.552,.496,12,18,.667,2,23,25,43,10,2,16,17,139
117,Devon Dotson\dotsode01,PG,21,CHI,1,0,10,2,4,.500,0,0,,2,4,.500,.500,0,0,,0,1,1,0,0,0,0,1,4
118,Sekou Doumbouya\doumbse01,PF,20,DET,16,0,189,24,68,.353,10,26,.385,14,42,.333,.426,14,17,.824,9,30,39,7,5,2,7,17,72
119,PJ Dozier\doziepj01,SG,24,DEN,17,0,330,44,94,.468,15,37,.405,29,57,.509,.548,18,25,.720,16,54,70,23,9,10,13,29,121
120,Goran Dragić\dragigo01,PG,34,MIA,14,5,376,80,168,.476,25,68,.368,55,100,.550,.551,37,46,.804,6,34,40,74,7,1,40,40,222
121,Andre Drummond\drumman01,C,27,CLE,16,16,486,123,254,.484,0,7,.000,123,247,.498,.484,53,91,.582,69,165,234,43,23,22,58,50,299
122,Jared Dudley\dudleja01,PF,35,LAL,6,0,22,1,1,1.000,1,1,1.000,0,0,,1.500,0,0,,1,5,6,1,0,0,0,0,3
123,Kevin Durant\duranke01,PF,32,BRK,14,14,509,142,274,.518,41,92,.446,101,182,.555,.593,101,117,.863,6,101,107,81,11,20,49,30,426
124,Anthony Edwards\edwaran01,SG,19,MIN,16,0,396,72,209,.344,23,84,.274,49,125,.392,.400,29,36,.806,15,29,44,26,10,2,30,25,196
125,Carsen Edwards\edwarca01,SG,22,BOS,6,0,60,15,31,.484,4,13,.308,11,18,.611,.548,3,4,.750,2,6,8,3,3,1,3,8,37
126,CJ Elleby\ellebcj01,SF,20,POR,6,0,34,5,8,.625,2,5,.400,3,3,1.000,.750,2,3,.667,1,1,2,2,0,1,1,7,14
127,Wayne Ellington\ellinwa01,SG,33,DET,12,9,278,52,97,.536,40,77,.519,12,20,.600,.742,7,10,.700,6,19,25,13,5,3,9,18,151
128,Joel Embiid\embiijo01,C,26,PHI,14,14,442,123,222,.554,17,42,.405,106,180,.589,.592,125,150,.833,26,135,161,38,18,19,44,32,388
129,James Ennis\ennisja01,SF,30,ORL,11,10,216,20,49,.408,6,19,.316,14,30,.467,.469,4,4,1.000,10,22,32,17,9,5,11,22,50
130,Drew Eubanks\eubandr01,PF,23,SAS,3,0,58,3,13,.231,0,0,,3,13,.231,.231,3,4,.750,1,12,13,1,1,6,1,7,9
131,Dante Exum\exumda01,SG,25,CLE,6,3,116,10,26,.385,2,11,.182,8,15,.533,.423,1,2,.500,2,15,17,13,4,2,7,9,23
132,Tacko Fall\fallta01,C,25,BOS,4,0,42,5,8,.625,0,0,,5,8,.625,.625,2,4,.500,4,11,15,0,0,8,1,6,12
133,Derrick Favors\favorde01,C,29,UTA,16,0,257,41,69,.594,0,0,,41,69,.594,.594,15,23,.652,32,60,92,15,5,17,8,41,97
134,Cristiano Felício\feliccr01,C,28,CHI,2,0,13,2,3,.667,0,0,,2,3,.667,.667,3,6,.500,3,2,5,2,1,0,0,1,7
135,Terrance Ferguson\fergute01,SG,22,PHI,6,0,22,0,3,.000,0,3,.000,0,0,,.000,0,0,,0,1,1,2,0,0,1,3,0
136,Bruno Fernando\fernabr01,C,22,ATL,9,0,92,6,15,.400,0,2,.000,6,13,.462,.400,2,5,.400,9,28,37,7,2,1,11,9,14
137,Yogi Ferrell\ferreyo01,PG,27,CLE,2,0,40,8,21,.381,3,9,.333,5,12,.417,.452,0,2,.000,3,4,7,5,3,1,3,4,19
138,Dorian Finney-Smith\finnedo01,PF,27,DAL,8,8,235,27,65,.415,14,43,.326,13,22,.591,.523,6,7,.857,11,29,40,8,11,5,4,24,74
139,Malachi Flynn\flynnma01,PG,22,TOR,11,0,101,10,37,.270,5,22,.227,5,15,.333,.338,0,2,.000,0,8,8,16,4,0,3,10,25
140,Bryn Forbes\forbebr01,SG,27,MIL,16,0,256,43,96,.448,22,54,.407,21,42,.500,.563,10,14,.714,2,12,14,5,4,0,12,20,118
141,Trent Forrest\forretr01,PG,22,UTA,2,0,9,0,0,,0,0,,0,0,,,2,2,1.000,0,0,0,1,1,0,0,2,2
142,Evan Fournier\fournev01,SF,28,ORL,9,9,256,54,110,.491,22,56,.393,32,54,.593,.591,34,46,.739,3,15,18,33,12,0,18,20,164
143,De'Aaron Fox\foxde01,PG,23,SAC,16,16,501,120,255,.471,25,69,.362,95,186,.511,.520,69,102,.676,9,39,48,95,23,10,48,37,334
144,Tim Frazier\fraziti01,PG,30,MEM,3,0,33,2,8,.250,0,2,.000,2,6,.333,.250,0,0,,0,4,4,7,1,0,3,4,4
145,Markelle Fultz\fultzma01,PG,22,ORL,8,8,215,41,104,.394,4,16,.250,37,88,.420,.413,17,19,.895,5,20,25,43,8,2,18,18,103
146,Daniel Gafford\gaffoda01,PF,22,CHI,15,3,216,28,44,.636,0,0,,28,44,.636,.636,20,30,.667,18,20,38,8,8,18,10,28,76
147,Danilo Gallinari\gallida01,PF,32,ATL,4,1,61,13,24,.542,6,13,.462,7,11,.636,.667,13,13,1.000,1,10,11,5,0,0,3,4,45
148,Langston Galloway\gallola01,SG,29,PHO,13,0,117,19,40,.475,14,29,.483,5,11,.455,.650,7,7,1.000,3,7,10,5,0,0,2,5,59
149,Darius Garland\garlada01,PG,21,CLE,9,6,286,50,120,.417,16,42,.381,34,78,.436,.483,13,14,.929,4,20,24,51,8,3,24,23,129
150,Marc Gasol\gasolma01,C,36,LAL,18,18,340,23,54,.426,10,29,.345,13,25,.520,.519,16,18,.889,17,64,81,34,8,26,20,45,72
151,Rudy Gay\gayru01,PF,34,SAS,17,0,384,78,177,.441,28,77,.364,50,100,.500,.520,16,21,.762,19,77,96,25,12,13,18,33,200
152,Paul George\georgpa01,SF,30,LAC,16,16,549,127,252,.504,60,124,.484,67,128,.523,.623,68,75,.907,8,91,99,87,19,8,64,34,382
153,Harry Giles\gilesha01,C,22,POR,12,0,125,13,30,.433,2,5,.400,11,25,.440,.467,6,9,.667,8,39,47,9,4,6,7,19,34
154,Shai Gilgeous-Alexander\gilgesh01,SG,22,OKC,16,16,541,124,240,.517,29,75,.387,95,165,.576,.577,73,96,.760,11,76,87,102,14,8,43,35,350
155,Anthony Gill\gillan01,PF,28,WAS,5,0,24,2,4,.500,1,3,.333,1,1,1.000,.625,2,2,1.000,0,5,5,0,1,0,0,2,7
156,Rudy Gobert\goberru01,C,28,UTA,16,16,479,78,128,.609,0,0,,78,128,.609,.609,38,79,.481,55,161,216,23,7,43,24,31,194
157,Brandon Goodwin\goodwbr01,PG,25,ATL,14,0,198,23,72,.319,9,37,.243,14,35,.400,.382,10,14,.714,1,17,18,28,8,0,7,16,65
158,Aaron Gordon\gordoaa01,PF,25,ORL,16,16,474,82,183,.448,27,75,.360,55,108,.509,.522,45,74,.608,29,91,120,70,12,16,42,29,236
159,Eric Gordon\gordoer01,SG,32,HOU,11,5,314,67,145,.462,29,83,.349,38,62,.613,.562,33,41,.805,3,20,23,22,7,6,17,17,196
160,Devonte' Graham\grahade01,PG,25,CHO,17,17,578,76,225,.338,47,140,.336,29,85,.341,.442,36,47,.766,10,46,56,105,23,0,20,26,235
161,Jerami Grant\grantje01,SF,26,DET,17,17,616,138,311,.444,45,116,.388,93,195,.477,.516,92,107,.860,22,89,111,48,16,22,26,50,413
162,Danny Green\greenda02,SF,33,PHI,18,18,504,57,152,.375,42,115,.365,15,37,.405,.513,8,11,.727,19,44,63,42,22,12,25,33,164
163,Draymond Green\greendr01,PF,30,GSW,13,13,344,23,65,.354,7,30,.233,16,35,.457,.408,12,18,.667,4,55,59,86,13,2,31,39,65
164,JaMychal Green\greenja01,PF,30,DEN,13,0,274,49,107,.458,28,60,.467,21,47,.447,.589,20,25,.800,22,62,84,15,7,2,19,31,146
165,Javonte Green\greenja02,SG,27,BOS,9,0,158,20,39,.513,3,15,.200,17,24,.708,.551,11,17,.647,15,18,33,6,7,1,7,9,54
166,Jeff Green\greenje02,PF,34,BRK,19,9,469,55,98,.561,27,56,.482,28,42,.667,.699,16,19,.842,7,57,64,23,11,3,15,39,153
167,Josh Green\greenjo02,SG,20,DAL,14,5,196,14,33,.424,1,11,.091,13,22,.591,.439,6,10,.600,12,26,38,9,4,0,11,16,35
168,Blake Griffin\griffbl01,PF,31,DET,13,13,417,53,141,.376,27,83,.325,26,58,.448,.472,27,40,.675,5,75,80,52,10,2,24,25,160
169,Kyle Guy\guyky01,PG,23,SAC,4,0,34,4,14,.286,2,5,.400,2,9,.222,.357,5,6,.833,0,5,5,7,1,0,0,0,15
170,Rui Hachimura\hachiru01,PF,22,WAS,7,7,194,35,70,.500,4,13,.308,31,57,.544,.529,21,28,.750,6,26,32,16,4,1,5,17,95
171,Ashton Hagans\haganas01,PG,21,MIN,1,0,2,0,0,,0,0,,0,0,,,0,0,,0,0,0,0,0,0,1,0,0
172,Tyrese Haliburton\halibty01,PG,20,SAC,14,1,392,60,119,.504,31,66,.470,29,53,.547,.634,9,11,.818,11,31,42,68,17,10,21,18,160
173,Josh Hall\halljo01,SF,20,OKC,5,0,39,3,16,.188,1,8,.125,2,8,.250,.219,2,5,.400,1,5,6,5,0,0,3,6,9
174,R.J. Hampton\hamptrj01,PG,19,DEN,10,0,29,3,8,.375,0,1,.000,3,7,.429,.375,2,2,1.000,2,3,5,0,0,0,2,3,8
175,Tim Hardaway Jr.\hardati02,SG,28,DAL,16,14,510,98,225,.436,50,130,.385,48,95,.505,.547,34,46,.739,5,58,63,29,10,3,17,26,280
176,James Harden\hardeja01,SG,31,TOT,14,14,531,102,225,.453,41,117,.350,61,108,.565,.544,91,105,.867,8,77,85,151,14,9,65,29,336
176,James Harden\hardeja01,SG,31,HOU,8,8,290,60,135,.444,25,72,.347,35,63,.556,.537,53,60,.883,5,36,41,83,7,6,34,14,198
176,James Harden\hardeja01,SG,31,BRK,6,6,241,42,90,.467,16,45,.356,26,45,.578,.556,38,45,.844,3,41,44,68,7,3,31,15,138
177,Maurice Harkless\harklma01,SF,27,MIA,9,3,96,4,10,.400,4,8,.500,0,2,.000,.600,0,2,.000,0,8,8,5,2,2,2,11,12
178,Jared Harper\harpeja01,PG,23,NYK,2,0,5,0,1,.000,0,0,,0,1,.000,.000,2,2,1.000,0,0,0,0,0,0,2,0,2
179,Montrezl Harrell\harremo01,C,27,LAL,18,0,447,99,157,.631,0,4,.000,99,153,.647,.631,49,66,.742,49,78,127,19,9,10,19,39,247
180,Gary Harris\harriga01,SG,26,DEN,15,15,476,62,137,.453,22,65,.338,40,72,.556,.533,18,25,.720,11,28,39,22,13,4,10,33,164
181,Jalen Harris\harrija01,SG,22,TOR,2,0,4,0,0,,0,0,,0,0,,,0,0,,1,0,1,0,0,0,1,2,0
182,Joe Harris\harrijo01,SF,29,BRK,19,15,590,103,205,.502,61,126,.484,42,79,.532,.651,7,12,.583,14,64,78,37,9,6,16,46,274
183,Tobias Harris\harrito02,PF,28,PHI,15,15,503,117,226,.518,33,72,.458,84,154,.545,.591,30,35,.857,19,81,100,42,14,15,36,30,297
184,Shaquille Harrison\harrish01,SG,27,UTA,9,0,41,6,17,.353,0,0,,6,17,.353,.353,1,2,.500,2,6,8,6,2,0,5,2,13
185,Josh Hart\hartjo01,SF,25,NOP,15,2,423,39,88,.443,19,53,.358,20,35,.571,.551,17,25,.680,14,101,115,25,13,2,11,35,114
186,Isaiah Hartenstein\harteis01,C,22,DEN,12,0,111,19,38,.500,0,0,,19,38,.500,.500,13,22,.591,20,20,40,7,5,9,11,27,51
187,Jaxson Hayes\hayesja02,C,20,NOP,15,0,191,22,38,.579,0,0,,22,38,.579,.579,11,16,.688,18,40,58,9,4,7,13,25,55
188,Killian Hayes\hayeski01,PG,19,DET,7,7,148,13,47,.277,5,20,.250,8,27,.296,.330,1,2,.500,1,7,8,25,2,0,17,15,32
189,Gordon Hayward\haywago01,SF,30,CHO,16,16,561,140,272,.515,37,85,.435,103,187,.551,.583,69,80,.863,12,75,87,57,21,7,37,33,386
190,Juan Hernangómez\hernaju01,PF,25,MIN,11,6,224,27,68,.397,12,39,.308,15,29,.517,.485,7,10,.700,10,48,58,6,5,2,4,10,73
191,Willy Hernangómez\hernawi01,C,26,NOP,3,0,12,2,4,.500,0,0,,2,4,.500,.500,1,4,.250,2,6,8,1,0,0,0,1,5
192,Tyler Herro\herroty01,SG,21,MIA,10,10,337,67,143,.469,16,53,.302,51,90,.567,.524,26,34,.765,1,66,67,38,4,1,28,16,176
193,Buddy Hield\hieldbu01,SG,28,SAC,16,16,535,81,219,.370,60,160,.375,21,59,.356,.507,17,20,.850,3,62,65,48,14,6,30,48,239
194,George Hill\hillge01,PG,34,OKC,14,14,369,61,120,.508,22,57,.386,39,63,.619,.600,21,25,.840,8,21,29,43,12,2,12,12,165
195,Solomon Hill\hillso01,PF,29,ATL,16,1,319,28,76,.368,21,59,.356,7,17,.412,.507,5,5,1.000,8,34,42,17,10,5,11,29,82
196,Nate Hinton\hintona01,SG,21,DAL,5,0,17,2,11,.182,0,3,.000,2,8,.250,.182,1,2,.500,0,0,0,0,1,1,2,1,5
197,Aaron Holiday\holidaa01,PG,24,IND,17,6,355,44,122,.361,17,58,.293,27,64,.422,.430,5,6,.833,4,18,22,37,12,3,11,37,110
198,Jrue Holiday\holidjr01,PG,30,MIL,16,16,522,101,205,.493,28,73,.384,73,132,.553,.561,27,33,.818,16,53,69,83,30,9,24,31,257
199,Justin Holiday\holidju01,SG,31,IND,17,8,520,66,133,.496,33,82,.402,33,51,.647,.620,18,24,.750,12,55,67,20,20,5,15,45,183
200,Richaun Holmes\holmeri01,C,27,SAC,15,15,460,86,127,.677,1,4,.250,85,123,.691,.681,27,32,.844,39,80,119,29,13,25,17,62,200
201,Rodney Hood\hoodro01,SF,28,POR,13,2,196,19,56,.339,7,25,.280,12,31,.387,.402,1,1,1.000,2,16,18,18,10,2,11,11,46
202,Al Horford\horfoal01,C,34,OKC,9,9,244,41,98,.418,16,50,.320,25,48,.521,.500,2,4,.500,5,59,64,22,3,7,8,14,100
203,Talen Horton-Tucker\hortota01,SG,20,LAL,14,0,224,36,84,.429,8,29,.276,28,55,.509,.476,19,22,.864,7,25,32,26,12,6,15,26,99
204,Danuel House\houseda01,SF,27,HOU,4,4,130,10,27,.370,3,15,.200,7,12,.583,.426,7,10,.700,1,17,18,9,1,1,1,10,30
205,Dwight Howard\howardw01,C,35,PHI,18,4,321,45,77,.584,3,7,.429,42,70,.600,.604,24,44,.545,45,97,142,13,8,17,35,57,117
206,Markus Howard\howarma02,SG,21,DEN,6,0,10,2,9,.222,0,6,.000,2,3,.667,.222,0,0,,0,0,0,1,0,0,0,2,4
207,Kevin Huerter\huertke01,SG,22,ATL,16,5,473,72,171,.421,32,89,.360,40,82,.488,.515,11,13,.846,12,49,61,55,21,1,19,34,187
208,Elijah Hughes\hugheel01,SF,22,UTA,6,0,27,5,15,.333,3,10,.300,2,5,.400,.433,3,4,.750,0,4,4,3,1,1,4,0,16
209,De'Andre Hunter\huntede01,SF,23,ATL,15,15,485,91,175,.520,27,69,.391,64,106,.604,.597,52,60,.867,14,73,87,31,14,6,23,46,261
210,Chandler Hutchison\hutchch01,SF,24,CHI,5,0,59,5,18,.278,1,3,.333,4,15,.267,.306,2,2,1.000,1,18,19,4,1,0,4,7,13
211,Serge Ibaka\ibakase01,C,31,LAC,16,16,399,78,144,.542,16,43,.372,62,101,.614,.597,23,28,.821,27,77,104,27,4,16,21,34,195
212,Andre Iguodala\iguodan01,SF,37,MIA,15,2,311,25,65,.385,17,48,.354,8,17,.471,.515,4,7,.571,8,43,51,33,18,6,18,20,71
213,Joe Ingles\inglejo01,SF,33,UTA,12,0,289,46,90,.511,26,61,.426,20,29,.690,.656,7,9,.778,6,35,41,43,4,3,17,22,125
214,Brandon Ingram\ingrabr01,SF,23,NOP,15,15,525,124,265,.468,31,83,.373,93,182,.511,.526,71,84,.845,11,73,84,69,10,14,46,24,350
215,Kyrie Irving\irvinky01,PG,28,BRK,11,11,386,116,227,.511,37,87,.425,79,140,.564,.593,40,42,.952,8,46,54,62,13,7,25,32,309
216,Wesley Iwundu\iwundwe01,SF,26,DAL,13,3,214,13,41,.317,3,21,.143,10,20,.500,.354,6,8,.750,5,27,32,7,7,1,3,17,35
217,Frank Jackson\jacksfr01,PG,22,DET,3,0,24,2,10,.200,2,8,.250,0,2,.000,.300,0,0,,0,4,4,5,1,0,3,3,6
218,Josh Jackson\jacksjo02,SG,23,DET,15,6,340,64,153,.418,19,66,.288,45,87,.517,.480,26,41,.634,7,37,44,24,15,14,27,42,173
219,Justin Jackson\jacksju01,SF,25,OKC,6,1,81,12,27,.444,3,16,.188,9,11,.818,.500,8,10,.800,2,11,13,6,2,0,5,5,35
220,Reggie Jackson\jacksre01,SG,30,LAC,14,1,189,33,74,.446,15,39,.385,18,35,.514,.547,6,11,.545,1,21,22,28,5,1,9,19,87
221,Justin James\jamesju01,SF,24,SAC,6,0,48,6,15,.400,0,4,.000,6,11,.545,.400,1,7,.143,2,5,7,3,1,1,0,1,13
222,LeBron James\jamesle01,PG,36,LAL,18,18,588,166,334,.497,49,119,.412,117,215,.544,.570,72,101,.713,12,131,143,133,17,8,66,24,453
223,Isaiah Joe\joeis01,SG,21,PHI,10,1,182,21,58,.362,17,46,.370,4,12,.333,.509,5,5,1.000,4,12,16,13,4,4,4,18,64
224,Cameron Johnson\johnsca02,PF,24,PHO,15,4,372,64,143,.448,36,102,.353,28,41,.683,.573,14,17,.824,9,39,48,23,11,7,12,17,178
225,James Johnson\johnsja01,PF,33,DAL,17,0,347,48,99,.485,14,45,.311,34,54,.630,.556,11,22,.500,9,46,55,31,18,13,19,37,121
226,Keldon Johnson\johnske04,SF,21,SAS,17,17,530,87,188,.463,18,52,.346,69,136,.507,.511,49,63,.778,28,96,124,38,15,11,25,50,241
227,Stanley Johnson\johnsst04,PF,24,TOR,15,1,245,15,37,.405,8,19,.421,7,18,.389,.514,7,10,.700,11,37,48,27,14,7,11,25,45
228,Tyler Johnson\johnsty01,SG,28,BRK,5,0,32,3,7,.429,3,5,.600,0,2,.000,.643,0,0,,1,1,2,7,3,0,0,1,9
229,Nikola Jokić\jokicni01,C,25,DEN,17,17,605,165,293,.563,18,53,.340,147,240,.613,.594,84,100,.840,58,144,202,158,32,9,71,54,432
230,Damian Jones\jonesda03,C,25,PHO,5,0,42,3,6,.500,0,1,.000,3,5,.600,.500,2,5,.400,4,5,9,0,1,3,3,9,8
231,Derrick Jones Jr.\jonesde02,SF,23,POR,16,16,440,43,94,.457,10,40,.250,33,54,.611,.511,19,34,.559,24,42,66,11,17,13,13,43,115
232,Mason Jones\jonesma05,SG,22,HOU,9,1,120,27,47,.574,14,24,.583,13,23,.565,.723,9,17,.529,3,17,20,13,4,0,14,10,77
233,Tre Jones\jonestr01,PG,21,SAS,7,0,23,6,10,.600,1,1,1.000,5,9,.556,.650,3,3,1.000,3,0,3,1,0,0,2,2,16
234,Tyus Jones\jonesty01,PG,24,MEM,13,8,336,48,112,.429,8,35,.229,40,77,.519,.464,5,7,.714,7,30,37,70,21,3,14,6,109
235,DeAndre Jordan\jordade01,C,32,BRK,18,14,368,48,59,.814,0,0,,48,59,.814,.814,13,22,.591,25,97,122,31,5,24,32,41,109
236,Cory Joseph\josepco01,PG,29,SAC,16,0,319,39,94,.415,9,33,.273,30,61,.492,.463,17,23,.739,7,29,36,37,12,6,18,41,104
237,Mfiondu Kabengele\kabenmf01,PF,23,LAC,11,0,48,3,14,.214,2,9,.222,1,5,.200,.286,3,4,.750,0,7,7,2,2,2,2,10,11
238,Frank Kaminsky\kaminfr01,C,27,PHO,9,0,102,16,41,.390,5,15,.333,11,26,.423,.451,2,6,.333,7,15,22,8,0,5,2,13,39
239,Enes Kanter\kanteen01,C,28,POR,16,4,335,68,110,.618,0,0,,68,110,.618,.618,26,32,.813,60,100,160,18,10,14,14,36,162
240,Luke Kennard\kennalu01,SG,24,LAC,17,3,389,54,112,.482,27,60,.450,27,52,.519,.603,9,10,.900,3,47,50,32,3,5,19,29,144
241,Maxi Kleber\klebima01,PF,29,DAL,9,3,219,18,41,.439,16,34,.471,2,7,.286,.634,15,16,.938,7,41,48,12,3,8,6,17,67
242,Nathan Knight\knighna01,PF,23,ATL,7,0,40,5,15,.333,3,7,.429,2,8,.250,.433,4,5,.800,6,5,11,1,0,3,4,6,17
243,Kevin Knox\knoxke01,SF,21,NYK,18,0,348,43,109,.394,25,64,.391,18,45,.400,.509,10,12,.833,8,34,42,16,7,6,14,29,121
244,John Konchar\konchjo01,SG,24,MEM,6,0,105,12,26,.462,3,8,.375,9,18,.500,.519,6,6,1.000,6,18,24,16,8,2,1,7,33
245,Furkan Korkmaz\korkmfu01,SG,23,PHI,7,0,120,15,49,.306,10,33,.303,5,16,.313,.408,6,7,.857,1,15,16,6,4,2,7,6,46
246,Luke Kornet\kornelu01,PF,25,CHI,1,0,7,0,2,.000,0,2,.000,0,0,,.000,2,2,1.000,0,1,1,0,1,0,1,0,2
247,Rodions Kurucs\kurucro01,PF-SF,22,TOT,7,0,43,3,10,.300,1,6,.167,2,4,.500,.350,0,0,,0,9,9,3,3,0,3,5,7
247,Rodions Kurucs\kurucro01,PF,22,BRK,5,0,16,1,3,.333,1,2,.500,0,1,.000,.500,0,0,,0,3,3,2,0,0,0,1,3
247,Rodions Kurucs\kurucro01,SF,22,HOU,2,0,27,2,7,.286,0,4,.000,2,3,.667,.286,0,0,,0,6,6,1,3,0,3,4,4
248,Kyle Kuzma\kuzmaky01,SF,25,LAL,18,4,439,69,161,.429,30,79,.380,39,82,.476,.522,8,12,.667,26,74,100,19,4,13,27,35,176
249,Jeremy Lamb\lambje01,SG,28,IND,4,0,100,23,43,.535,7,17,.412,16,26,.615,.616,14,15,.933,5,14,19,3,4,1,4,11,67
250,Zach LaVine\lavinza01,SG,25,CHI,17,17,605,158,315,.502,58,146,.397,100,169,.592,.594,85,97,.876,10,79,89,90,22,11,73,48,459
251,Jake Layman\laymaja01,SF,26,MIN,11,3,154,19,41,.463,2,14,.143,17,27,.630,.488,14,16,.875,1,11,12,9,8,5,5,17,54
252,Jalen Lecque\lecquja01,PG,20,IND,3,0,9,1,4,.250,0,1,.000,1,3,.333,.250,3,3,1.000,1,3,4,2,0,0,0,0,5
253,Damion Lee\leeda03,SG,28,GSW,17,0,310,35,78,.449,24,60,.400,11,18,.611,.603,14,16,.875,9,47,56,25,11,1,6,30,108
254,Saben Lee\leesa01,PG,21,DET,5,0,50,4,11,.364,0,1,.000,4,10,.400,.364,6,8,.750,1,2,3,6,4,0,5,6,14
255,Alex Len\lenal01,C,27,TOT,8,2,97,9,16,.563,4,8,.500,5,8,.625,.688,5,10,.500,0,16,16,4,2,6,10,11,27
255,Alex Len\lenal01,C,27,TOR,7,2,76,5,10,.500,3,6,.500,2,4,.500,.650,3,6,.500,0,11,11,3,1,6,8,10,16
255,Alex Len\lenal01,C,27,WAS,1,0,21,4,6,.667,1,2,.500,3,4,.750,.750,2,4,.500,0,5,5,1,1,0,2,1,11
256,Kawhi Leonard\leonaka01,SF,29,LAC,15,15,518,143,283,.505,31,74,.419,112,209,.536,.560,72,80,.900,15,66,81,86,30,10,27,26,389
257,Meyers Leonard\leoname01,C,28,MIA,3,2,29,3,7,.429,3,7,.429,0,0,,.643,1,2,.500,0,7,7,2,0,0,2,5,10
258,Caris LeVert\leverca01,SG,26,BRK,12,4,334,87,200,.435,22,63,.349,65,137,.474,.490,26,34,.765,10,42,52,72,13,6,26,20,222
259,Kira Lewis Jr.\lewiski01,PG,19,NOP,7,0,60,9,29,.310,2,8,.250,7,21,.333,.345,5,6,.833,0,4,4,9,1,1,1,6,25
260,Damian Lillard\lillada01,PG,30,POR,16,16,580,138,309,.447,61,163,.374,77,146,.527,.545,122,129,.946,7,70,77,112,15,4,49,25,459
261,Nassir Little\littlna01,PF,20,POR,6,0,54,3,10,.300,1,4,.250,2,6,.333,.350,3,4,.750,3,9,12,1,0,2,3,5,10
262,Kevon Looney\looneke01,C,24,GSW,17,1,244,26,40,.650,2,5,.400,24,35,.686,.675,9,13,.692,21,43,64,25,5,4,12,33,63
263,Brook Lopez\lopezbr01,C,32,MIL,16,16,438,58,134,.433,28,80,.350,30,54,.556,.537,17,20,.850,23,60,83,12,9,25,11,30,161
264,Robin Lopez\lopezro01,C,32,WAS,12,2,202,31,50,.620,2,5,.400,29,45,.644,.640,15,27,.556,23,30,53,11,1,7,9,24,79
265,Kevin Love\loveke01,PF,32,CLE,2,2,46,6,18,.333,3,9,.333,3,9,.333,.417,4,5,.800,2,10,12,5,1,0,3,1,19
266,Kyle Lowry\lowryky01,PG,34,TOR,14,14,504,78,188,.415,38,108,.352,40,80,.500,.516,55,62,.887,13,74,87,93,14,3,43,48,249
267,Timothé Luwawu-Cabarrot\luwawti01,SF,25,BRK,19,4,368,50,129,.388,29,83,.349,21,46,.457,.500,12,15,.800,10,28,38,24,9,3,12,34,141
268,Trey Lyles\lylestr01,PF,25,SAS,9,2,100,8,21,.381,2,10,.200,6,11,.545,.429,3,7,.429,6,25,31,4,0,0,0,3,21
269,Thon Maker\makerth01,C,23,CLE,8,0,76,10,18,.556,0,2,.000,10,16,.625,.556,10,11,.909,8,10,18,4,2,4,3,7,30
270,Théo Maledon\maledth01,PG,19,OKC,16,1,318,37,103,.359,17,57,.298,20,46,.435,.442,5,11,.455,3,36,39,44,9,0,27,34,96
271,Karim Mané\maneka01,PG,20,ORL,6,0,56,1,9,.111,1,2,.500,0,7,.000,.167,4,4,1.000,0,10,10,1,0,1,3,3,7
272,Terance Mann\mannte01,SG,24,LAC,15,0,129,13,34,.382,2,8,.250,11,26,.423,.412,3,6,.500,10,26,36,9,3,2,8,13,31
273,Nico Mannion\mannini01,PG,19,GSW,4,0,28,3,9,.333,2,6,.333,1,3,.333,.444,1,2,.500,0,3,3,10,2,0,2,3,9
274,Boban Marjanović\marjabo01,C,32,DAL,12,0,97,26,49,.531,0,3,.000,26,46,.565,.531,7,10,.700,17,23,40,0,0,0,3,12,59
275,Lauri Markkanen\markkla01,PF,23,CHI,10,10,304,64,132,.485,26,69,.377,38,63,.603,.583,31,37,.838,8,57,65,10,8,4,17,24,185
276,Naji Marshall\marshna01,SF,23,NOP,3,0,8,0,2,.000,0,1,.000,0,1,.000,.000,1,2,.500,0,2,2,1,0,0,0,0,1
277,Caleb Martin\martica02,SF,25,CHO,16,1,235,36,81,.444,8,33,.242,28,48,.583,.494,10,17,.588,13,29,42,22,14,4,12,13,90
278,Cody Martin\martico01,SF,25,CHO,11,0,125,15,28,.536,2,10,.200,13,18,.722,.571,6,8,.750,8,17,25,14,5,0,6,6,38
279,Kelan Martin\martike03,SF,25,IND,7,0,31,3,14,.214,1,6,.167,2,8,.250,.250,0,0,,1,7,8,0,2,0,4,4,7
280,Kenyon Martin Jr.\martike04,SF,20,HOU,7,0,69,10,27,.370,1,4,.250,9,23,.391,.389,2,5,.400,8,11,19,4,2,5,5,9,23
281,Garrison Mathews\mathega01,SG,24,WAS,6,0,99,15,34,.441,11,24,.458,4,10,.400,.603,8,9,.889,5,7,12,5,7,1,2,13,49
282,Dakota Mathias\mathida01,SG,25,PHI,8,2,123,19,48,.396,8,26,.308,11,22,.500,.479,2,6,.333,1,6,7,13,1,3,1,7,48
283,Wesley Matthews\matthwe02,SG,34,LAL,15,1,294,25,60,.417,18,50,.360,7,10,.700,.567,6,8,.750,5,10,15,17,5,4,2,19,74
284,Tyrese Maxey\maxeyty01,SG,20,PHI,18,6,363,79,170,.465,12,41,.293,67,129,.519,.500,10,12,.833,6,38,44,37,14,3,13,24,180
285,Skylar Mays\mayssk01,SG,23,ATL,3,0,11,0,3,.000,0,1,.000,0,2,.000,.000,0,0,,0,0,0,1,0,0,0,1,0
286,CJ McCollum\mccolcj01,SG,29,POR,13,13,440,123,260,.473,63,143,.441,60,117,.513,.594,38,45,.844,7,44,51,65,17,4,13,28,347
287,T.J. McConnell\mccontj01,PG,28,IND,14,0,287,29,55,.527,2,6,.333,27,49,.551,.545,1,3,.333,8,36,44,77,26,2,20,19,61
288,Jaden McDaniels\mcdanja02,PF,20,MIN,10,0,144,18,49,.367,9,23,.391,9,26,.346,.459,1,5,.200,8,22,30,8,3,7,5,20,46
289,Jalen McDaniels\mcdanja01,SF,23,CHO,9,0,83,13,25,.520,2,6,.333,11,19,.579,.560,7,11,.636,3,16,19,5,2,0,8,13,35
290,Doug McDermott\mcderdo01,PF,29,IND,17,5,436,77,157,.490,31,82,.378,46,75,.613,.589,23,30,.767,13,50,63,24,5,1,16,30,208
291,Sean McDermott\mcderse01,SF,24,MEM,3,0,42,2,7,.286,1,5,.200,1,2,.500,.357,2,2,1.000,2,1,3,3,0,0,3,1,7
292,JaVale McGee\mcgeeja01,C,33,CLE,15,1,248,49,109,.450,4,13,.308,45,96,.469,.468,21,36,.583,27,62,89,18,9,17,17,37,123
293,Rodney McGruder\mcgruro01,SG,29,DET,3,0,14,1,2,.500,0,1,.000,1,1,1.000,.500,1,1,1.000,1,0,1,0,0,0,0,1,3
294,Alfonzo McKinnie\mckinal01,SF,28,LAL,10,0,33,8,12,.667,3,4,.750,5,8,.625,.792,2,2,1.000,3,4,7,0,0,0,1,2,21
295,Jordan McLaughlin\mclaujo01,PG,24,MIN,9,0,158,22,49,.449,6,16,.375,16,33,.485,.510,4,5,.800,4,16,20,39,6,1,10,4,54
296,Ben McLemore\mclembe01,SG,27,HOU,9,2,186,26,64,.406,19,44,.432,7,20,.350,.555,4,5,.800,4,23,27,16,5,1,15,14,75
297,Nicolò Melli\mellini01,PF,30,NOP,9,0,103,4,20,.200,3,16,.188,1,4,.250,.275,3,4,.750,2,19,21,9,4,1,4,9,14
298,De'Anthony Melton\meltode01,PG,22,MEM,7,0,139,25,54,.463,6,17,.353,19,37,.514,.519,1,2,.500,1,15,16,17,9,6,10,12,57
299,Sam Merrill\merrisa01,SG,24,MIL,7,0,43,4,8,.500,4,6,.667,0,2,.000,.750,2,2,1.000,3,6,9,10,1,0,3,3,14
300,Chimezie Metu\metuch01,C,23,SAC,7,0,61,13,28,.464,1,3,.333,12,25,.480,.482,6,9,.667,11,12,23,4,2,6,4,10,33
301,Khris Middleton\middlkh01,SF,29,MIL,16,16,526,131,251,.522,40,94,.426,91,157,.580,.602,46,50,.920,16,85,101,92,16,3,37,43,348
302,Darius Miller\milleda01,SF,30,OKC,3,0,14,1,5,.200,1,5,.200,0,0,,.300,0,0,,0,1,1,1,0,0,1,2,3
303,Patty Mills\millspa02,PG,32,SAS,17,0,435,89,191,.466,48,113,.425,41,78,.526,.592,20,22,.909,5,25,30,51,7,1,14,23,246
304,Paul Millsap\millspa01,PF,35,DEN,17,17,393,59,120,.492,20,49,.408,39,71,.549,.575,26,37,.703,27,60,87,26,13,5,18,34,164
305,Shake Milton\miltosh01,SG,24,PHI,15,1,385,77,165,.467,19,58,.328,58,107,.542,.524,53,60,.883,5,22,27,48,15,3,26,35,226
306,Donovan Mitchell\mitchdo01,SG,24,UTA,16,16,531,137,310,.442,56,138,.406,81,172,.471,.532,58,69,.841,16,50,66,80,12,7,51,31,388
307,Adam Mokoka\mokokad01,SG,22,CHI,6,0,41,5,14,.357,1,8,.125,4,6,.667,.393,0,0,,1,3,4,4,2,1,2,5,11
308,Malik Monk\monkma01,SG,22,CHO,4,0,38,3,8,.375,3,7,.429,0,1,.000,.563,4,6,.667,1,2,3,6,0,0,2,3,13
309,E'Twaun Moore\mooreet01,SG,31,PHO,2,0,9,1,4,.250,0,1,.000,1,3,.333,.250,0,0,,1,0,1,0,0,0,2,2,2
310,Ja Morant\moranja01,PG,21,MEM,5,5,146,42,79,.532,4,14,.286,38,65,.585,.557,25,31,.806,2,8,10,35,5,3,14,11,113
311,Juwan Morgan\morgaju01,PF,23,UTA,5,0,21,1,3,.333,1,3,.333,0,0,,.500,0,0,,0,4,4,1,0,0,1,1,3
312,Marcus Morris\morrima03,PF,31,LAC,8,0,181,30,70,.429,18,38,.474,12,32,.375,.557,8,9,.889,7,22,29,8,3,1,11,13,86
313,Markieff Morris\morrima02,PF,31,LAL,17,1,248,27,65,.415,15,44,.341,12,21,.571,.531,8,11,.727,10,49,59,16,1,6,9,25,77
314,Monte Morris\morrimo01,PG,25,DEN,17,1,458,75,145,.517,21,58,.362,54,87,.621,.590,25,35,.714,5,35,40,55,13,6,10,12,196
315,Mychal Mulder\muldemy01,PG,26,GSW,16,0,159,19,38,.500,15,33,.455,4,5,.800,.697,6,9,.667,0,14,14,8,5,2,4,13,59
316,Dejounte Murray\murrade01,PG,24,SAS,17,17,519,103,230,.448,17,56,.304,86,174,.494,.485,25,31,.806,12,109,121,92,23,2,28,35,248
317,Jamal Murray\murraja01,PG,23,DEN,16,16,559,116,258,.450,34,100,.340,82,158,.519,.516,43,56,.768,12,49,61,68,16,4,33,39,309
318,Mike Muscala\muscami01,C,29,OKC,15,0,276,51,118,.432,33,89,.371,18,29,.621,.572,12,14,.857,7,41,48,10,5,6,9,26,147
319,Sviatoslav Mykhailiuk\mykhasv01,SF,23,DET,17,0,243,38,100,.380,26,79,.329,12,21,.571,.510,21,24,.875,3,24,27,19,12,3,8,13,123
320,Abdel Nader\naderab01,SF,27,PHO,4,0,64,8,17,.471,2,5,.400,6,12,.500,.529,4,6,.667,0,10,10,4,1,0,1,5,22
321,Larry Nance Jr.\nancela02,PF,28,CLE,16,15,551,66,130,.508,24,57,.421,42,73,.575,.600,12,21,.571,22,78,100,56,36,8,26,33,168
322,Aaron Nesmith\nesmiaa01,SF,21,BOS,7,0,101,12,34,.353,9,26,.346,3,8,.375,.485,0,0,,3,10,13,4,0,2,4,14,33
323,Raul Neto\netora01,PG,28,WAS,11,4,186,39,74,.527,14,33,.424,25,41,.610,.622,6,9,.667,3,11,14,18,11,0,9,16,98
324,Georges Niang\niangge01,PF,27,UTA,16,0,182,29,66,.439,14,41,.341,15,25,.600,.545,1,1,1.000,3,31,34,9,2,0,14,22,73
325,Zeke Nnaji\nnajize01,PF,20,DEN,6,0,16,1,4,.250,0,2,.000,1,2,.500,.250,0,0,,1,1,2,0,0,0,0,2,2
326,Nerlens Noel\noelne01,C,26,NYK,16,0,260,21,41,.512,0,1,.000,21,40,.525,.512,8,15,.533,25,59,84,7,15,26,17,28,50
327,Jaylen Nowell\nowelja01,SG,21,MIN,2,0,20,5,7,.714,1,2,.500,4,5,.800,.786,0,0,,2,1,3,1,1,0,1,2,11
328,Frank Ntilikina\ntilila01,PG,22,NYK,4,0,42,6,14,.429,5,9,.556,1,5,.200,.607,1,3,.333,1,3,4,3,3,0,2,7,18
329,Kendrick Nunn\nunnke01,PG,25,MIA,11,0,262,51,109,.468,15,46,.326,36,63,.571,.537,13,15,.867,4,30,34,28,9,3,20,16,130
330,Jusuf Nurkić\nurkiju01,C,26,POR,12,12,280,50,103,.485,3,12,.250,47,91,.516,.500,15,27,.556,23,69,92,33,11,11,23,33,118
331,David Nwaba\nwabada01,SF,28,HOU,14,8,333,47,100,.470,9,34,.265,38,66,.576,.515,21,31,.677,11,29,40,18,17,10,8,28,124
332,Jordan Nwora\nworajo01,SF,22,MIL,8,0,71,16,32,.500,7,14,.500,9,18,.500,.609,9,10,.900,1,14,15,0,4,1,8,9,48
333,Royce O'Neale\onealro01,SF,27,UTA,16,16,509,39,81,.481,30,65,.462,9,16,.563,.667,7,10,.700,16,89,105,36,10,8,16,41,115
334,Semi Ojeleye\ojelese01,PF,26,BOS,15,1,274,28,68,.412,16,44,.364,12,24,.500,.529,13,19,.684,11,35,46,11,1,0,7,17,85
335,Jahlil Okafor\okafoja01,C,25,DET,10,0,103,23,37,.622,0,2,.000,23,35,.657,.622,0,0,,11,12,23,3,2,1,4,10,46
336,Chuma Okeke\okekech01,PF,22,ORL,5,0,91,5,14,.357,2,7,.286,3,7,.429,.429,3,6,.500,5,8,13,8,3,1,3,2,15
337,Josh Okogie\okogijo01,SG,22,MIN,10,9,233,22,50,.440,4,20,.200,18,30,.600,.480,12,15,.800,7,22,29,15,9,7,10,24,60
338,Onyeka Okongwu\okongon01,C,20,ATL,4,1,48,6,12,.500,0,0,,6,12,.500,.500,0,2,.000,5,9,14,2,2,6,3,5,12
339,Isaac Okoro\okorois01,SG,20,CLE,12,12,431,36,92,.391,10,34,.294,26,58,.448,.446,18,28,.643,13,16,29,21,16,5,18,33,100
340,KZ Okpala\okpalkz01,PF,21,MIA,9,3,107,10,22,.455,6,14,.429,4,8,.500,.591,1,4,.250,4,10,14,3,2,1,6,12,27
341,Victor Oladipo\oladivi01,SG,28,TOT,12,12,399,88,213,.413,31,89,.348,57,124,.460,.486,40,54,.741,2,61,63,56,21,4,29,34,247
341,Victor Oladipo\oladivi01,SG,28,IND,9,9,300,64,152,.421,25,69,.362,39,83,.470,.503,27,37,.730,1,50,51,38,15,2,18,23,180
341,Victor Oladipo\oladivi01,SG,28,HOU,3,3,99,24,61,.393,6,20,.300,18,41,.439,.443,13,17,.765,1,11,12,18,6,2,11,11,67
342,Kelly Olynyk\olynyke01,C,29,MIA,15,11,404,54,130,.415,28,92,.304,26,38,.684,.523,8,11,.727,10,70,80,42,14,13,24,40,144
343,Miye Oni\onimi01,SG,23,UTA,11,0,90,5,18,.278,5,15,.333,0,3,.000,.417,1,2,.500,2,14,16,5,0,4,2,12,16
344,Cedi Osman\osmande01,SF,25,CLE,17,11,521,83,213,.390,44,121,.364,39,92,.424,.493,22,30,.733,10,52,62,59,17,3,27,44,232
345,Daniel Oturu\oturuda01,C,21,LAC,9,0,38,9,15,.600,0,1,.000,9,14,.643,.600,2,2,1.000,5,9,14,4,0,2,1,5,20
346,Kelly Oubre Jr.\oubreke01,SF,25,GSW,17,17,477,71,200,.355,19,87,.218,52,113,.460,.403,37,50,.740,24,69,93,20,21,16,23,37,198
347,Eric Paschall\pascher01,PF,24,GSW,16,2,295,67,137,.489,9,27,.333,58,110,.527,.522,33,43,.767,16,38,54,22,4,2,8,29,176
348,Anžejs Pasečņiks\pasecan01,C,25,WAS,1,0,6,0,1,.000,0,1,.000,0,0,,.000,0,0,,1,0,1,1,0,0,5,2,0
349,Patrick Patterson\pattepa01,PF,31,LAC,7,0,88,8,24,.333,6,20,.300,2,4,.500,.458,3,4,.750,3,7,10,4,3,0,6,9,25
350,Chris Paul\paulch01,PG,35,PHO,15,15,491,78,179,.436,13,47,.277,65,132,.492,.472,38,39,.974,8,63,71,135,14,4,34,45,207
351,Cameron Payne\payneca01,PG,26,PHO,13,0,227,33,72,.458,11,29,.379,22,43,.512,.535,9,9,1.000,2,26,28,51,8,3,16,28,86
352,Elfrid Payton\paytoel01,PG,26,NYK,18,18,528,94,216,.435,10,36,.278,84,180,.467,.458,29,41,.707,23,47,70,71,12,4,38,41,227
353,Reggie Perry\perryre01,PF,20,BRK,11,0,115,17,42,.405,1,8,.125,16,34,.471,.417,5,8,.625,14,24,38,9,2,4,8,17,40
354,Theo Pinson\pinsoth01,SG,25,NYK,6,0,16,0,5,.000,0,5,.000,0,0,,.000,0,0,,0,1,1,0,0,0,0,2,0
355,Mason Plumlee\plumlma01,C,30,DET,17,17,453,56,104,.538,0,4,.000,56,100,.560,.538,30,44,.682,54,92,146,54,19,9,35,64,142
356,Jakob Poeltl\poeltja01,C,25,SAS,17,3,340,42,75,.560,0,0,,42,75,.560,.560,5,21,.238,51,53,104,30,9,16,18,32,89
357,Vincent Poirier\poirivi01,C,27,PHI,3,0,14,1,3,.333,0,0,,1,3,.333,.333,2,4,.500,2,1,3,1,0,1,1,1,4
358,Aleksej Pokusevski\pokusal01,PF,19,OKC,14,0,237,18,75,.240,9,47,.191,9,28,.321,.300,0,0,,5,46,51,18,7,15,20,14,45
359,Jordan Poole\poolejo01,SG,21,GSW,12,0,116,19,47,.404,9,29,.310,10,18,.556,.500,13,14,.929,1,14,15,12,3,0,7,10,60
360,Michael Porter Jr.\portemi01,SF,22,DEN,7,4,199,48,87,.552,21,44,.477,27,43,.628,.672,12,14,.857,10,42,52,9,8,7,6,16,129
361,Otto Porter\porteot01,SF,27,CHI,14,6,329,62,130,.477,27,63,.429,35,67,.522,.581,25,30,.833,17,75,92,28,9,3,14,22,176
362,Bobby Portis\portibo01,C,25,MIL,16,1,364,75,139,.540,13,31,.419,62,108,.574,.586,15,20,.750,35,92,127,18,13,7,15,32,178
363,Kristaps Porziņģis\porzikr01,C,25,DAL,7,7,214,54,115,.470,13,44,.295,41,71,.577,.526,17,21,.810,14,44,58,8,2,12,8,22,138
364,Dwight Powell\poweldw01,C,29,DAL,9,6,178,14,30,.467,1,5,.200,13,25,.520,.483,16,22,.727,10,22,32,11,11,5,8,23,45
365,Norman Powell\powelno01,SG,27,TOR,17,6,426,76,183,.415,34,89,.382,42,94,.447,.508,45,53,.849,2,37,39,23,16,3,21,30,231
366,Taurean Prince\princta02,PF,26,TOT,16,5,318,43,103,.417,21,53,.396,22,50,.440,.519,37,41,.902,6,44,50,21,14,11,17,27,144
366,Taurean Prince\princta02,PF,26,BRK,12,4,218,30,74,.405,13,37,.351,17,37,.459,.493,24,27,.889,2,32,34,7,8,8,11,21,97
366,Taurean Prince\princta02,PF,26,CLE,4,1,100,13,29,.448,8,16,.500,5,13,.385,.586,13,14,.929,4,12,16,14,6,3,6,6,47
367,Payton Pritchard\pritcpa01,SG,23,BOS,14,0,293,41,84,.488,17,40,.425,24,44,.545,.589,9,10,.900,6,27,33,36,13,5,22,25,108
368,Immanuel Quickley\quickim01,PG,21,NYK,14,0,249,50,124,.403,20,54,.370,30,70,.429,.484,34,36,.944,2,23,25,36,7,7,14,30,154
369,Jahmi'us Ramsey\ramseja01,SG,19,SAC,4,0,16,2,4,.500,1,3,.333,1,1,1.000,.625,0,0,,0,4,4,1,0,1,1,0,5
370,Julius Randle\randlju01,PF,26,NYK,18,18,662,142,300,.473,24,69,.348,118,231,.511,.513,101,125,.808,27,177,204,110,14,3,63,62,409
371,Cam Reddish\reddica01,SF,21,ATL,13,10,365,49,137,.358,20,67,.299,29,70,.414,.431,36,44,.818,12,49,61,15,18,3,20,33,154
372,J.J. Redick\redicjj01,SG,36,NOP,15,0,307,36,108,.333,24,80,.300,12,28,.429,.444,25,25,1.000,2,25,27,20,4,0,11,21,121
373,Paul Reed\reedpa01,PF,21,PHI,5,0,55,9,22,.409,0,3,.000,9,19,.474,.409,0,0,,7,3,10,3,1,4,5,4,18
374,Naz Reid\reidna01,C,21,MIN,16,8,349,69,131,.527,18,47,.383,51,84,.607,.595,30,38,.789,16,58,74,20,7,22,21,49,186
375,Nick Richards\richani01,PF,23,CHO,4,0,12,2,2,1.000,0,0,,2,2,1.000,1.000,1,2,.500,1,3,4,0,0,0,0,2,5
376,Josh Richardson\richajo01,SG,27,DAL,8,8,260,39,95,.411,16,50,.320,23,45,.511,.495,16,17,.941,9,14,23,13,7,2,10,30,110
377,Austin Rivers\riverau01,SG,28,NYK,12,2,310,38,91,.418,21,54,.389,17,37,.459,.533,2,4,.500,3,30,33,30,7,0,16,22,99
378,Duncan Robinson\robindu01,SF,26,MIA,16,16,546,71,159,.447,57,136,.419,14,23,.609,.626,29,33,.879,0,63,63,25,7,6,25,29,228
379,Glenn Robinson III\robingl02,SF,27,SAC,13,0,233,31,68,.456,14,31,.452,17,37,.459,.559,16,18,.889,5,21,26,14,0,1,6,13,92
380,Jerome Robinson\robinje01,SG,23,WAS,7,2,125,15,38,.395,7,20,.350,8,18,.444,.487,6,6,1.000,0,15,15,12,3,1,4,13,43
381,Mitchell Robinson\robinmi01,C,22,NYK,18,18,532,76,116,.655,0,0,,76,116,.655,.655,13,28,.464,72,79,151,8,22,30,13,49,165
382,Isaiah Roby\robyis01,PF,22,OKC,13,7,275,48,90,.533,8,24,.333,40,66,.606,.578,20,28,.714,24,43,67,19,7,6,12,35,124
383,Rajon Rondo\rondora01,PG,34,ATL,8,1,127,12,34,.353,5,16,.313,7,18,.389,.426,1,2,.500,4,17,21,35,3,1,11,5,30
384,Derrick Rose\rosede01,PG,32,DET,12,0,285,65,151,.430,11,33,.333,54,118,.458,.467,37,44,.841,4,22,26,55,15,4,25,17,178
385,Terrence Ross\rosste01,SG,29,ORL,17,0,482,86,209,.411,33,96,.344,53,113,.469,.490,44,50,.880,6,41,47,34,19,5,28,34,249
386,Terry Rozier\roziete01,SG,26,CHO,17,17,576,115,247,.466,53,124,.427,62,123,.504,.573,37,50,.740,10,58,68,50,24,8,30,37,320
387,Ricky Rubio\rubiori01,PG,30,MIN,14,5,338,28,81,.346,5,25,.200,23,56,.411,.377,27,32,.844,7,39,46,82,20,0,29,27,88
388,D'Angelo Russell\russeda01,PG,24,MIN,14,13,430,105,243,.432,42,105,.400,63,138,.457,.519,35,49,.714,8,34,42,77,19,7,45,30,287
389,Domantas Sabonis\sabondo01,PF,24,IND,17,17,624,132,246,.537,15,43,.349,117,203,.576,.567,67,97,.691,52,158,210,95,15,7,56,61,346
390,Luka Šamanić\samanlu01,PF,21,SAS,4,0,11,2,6,.333,2,3,.667,0,3,.000,.500,1,2,.500,0,0,0,0,0,0,0,0,7
391,JaKarr Sampson\sampsja02,PF,27,IND,8,0,59,8,18,.444,0,2,.000,8,16,.500,.444,4,5,.800,6,15,21,0,1,3,1,7,20
392,Dario Šarić\saricda01,PF,26,PHO,7,0,132,26,58,.448,10,28,.357,16,30,.533,.534,12,13,.923,3,29,32,7,4,1,11,14,74
393,Tomáš Satoranský\satorto01,SG,29,CHI,6,0,115,10,24,.417,4,10,.400,6,14,.429,.500,5,7,.714,2,8,10,31,7,1,12,8,29
394,Dennis Schröder\schrode01,SG,27,LAL,18,18,553,91,219,.416,18,61,.295,73,158,.462,.457,45,57,.789,12,56,68,76,19,3,43,49,245
395,Mike Scott\scottmi01,PF,32,PHI,8,2,153,14,44,.318,9,36,.250,5,8,.625,.420,2,3,.667,4,18,22,1,2,2,3,10,39
396,Collin Sexton\sextoco01,SG,22,CLE,12,12,412,111,220,.505,24,52,.462,87,168,.518,.559,52,64,.813,9,21,30,50,14,3,29,40,298
397,Landry Shamet\shamela01,SG,23,BRK,16,0,278,24,75,.320,16,56,.286,8,19,.421,.427,16,18,.889,3,21,24,17,10,2,12,20,80
398,Pascal Siakam\siakapa01,PF,26,TOR,14,14,496,99,224,.442,16,63,.254,83,161,.516,.478,46,60,.767,35,79,114,66,12,8,37,51,260
399,Chris Silva\silvach01,PF,24,MIA,6,0,53,6,9,.667,1,1,1.000,5,8,.625,.722,10,12,.833,7,11,18,6,1,2,8,14,23
400,Ben Simmons\simmobe01,PG,24,PHI,16,16,522,74,141,.525,1,6,.167,73,135,.541,.528,55,85,.647,21,114,135,126,27,14,59,58,204
401,Anfernee Simons\simonan01,SG,21,POR,13,0,168,31,76,.408,22,53,.415,9,23,.391,.553,4,6,.667,3,19,22,9,2,3,6,18,88
402,Deividas Sirvydis\sirvyde01,SG,20,DET,2,0,2,0,2,.000,0,2,.000,0,0,,.000,0,0,,0,0,0,0,0,0,0,0,0
403,Marcus Smart\smartma01,PG,26,BOS,15,15,484,66,166,.398,26,80,.325,40,86,.465,.476,46,62,.742,6,35,41,93,28,8,27,36,204
404,Dennis Smith Jr.\smithde03,PG,23,NYK,3,0,28,2,10,.200,0,4,.000,2,6,.333,.200,5,6,.833,0,2,2,3,3,0,1,4,9
405,Ish Smith\smithis01,PG,32,WAS,11,0,212,28,71,.394,4,12,.333,24,59,.407,.423,5,13,.385,6,31,37,44,7,3,11,12,65
406,Jalen Smith\smithja04,PF,20,PHO,3,0,29,4,8,.500,1,3,.333,3,5,.600,.563,0,2,.000,4,3,7,1,0,2,1,3,9
407,Tony Snell\snellto01,SG,29,ATL,7,0,66,4,16,.250,4,13,.308,0,3,.000,.375,0,0,,3,5,8,3,0,1,2,9,12
408,Cassius Stanley\stanlca01,SG,21,IND,8,0,23,2,7,.286,1,2,.500,1,5,.200,.357,4,5,.800,2,1,3,0,0,2,1,7,9
409,Lamar Stevens\stevela01,PF,23,CLE,10,0,129,15,37,.405,1,7,.143,14,30,.467,.419,8,10,.800,3,17,20,7,4,0,3,6,39
410,Isaiah Stewart\stewais01,C,19,DET,15,0,261,30,61,.492,0,1,.000,30,60,.500,.492,11,15,.733,38,43,81,11,7,13,11,41,71
411,Max Strus\strusma01,SF,24,MIA,7,0,99,12,29,.414,6,22,.273,6,7,.857,.517,1,3,.333,1,10,11,5,1,0,1,7,31
412,Edmond Sumner\sumneed01,SG,25,IND,9,4,118,21,42,.500,4,15,.267,17,27,.630,.548,6,10,.600,5,13,18,6,7,0,9,14,52
413,Jae'Sean Tate\tateja01,SF,25,HOU,15,5,392,51,98,.520,10,28,.357,41,70,.586,.571,18,27,.667,18,48,66,27,11,12,20,45,130
414,Jayson Tatum\tatumja01,SF,22,BOS,11,11,378,111,234,.474,38,86,.442,73,148,.493,.556,33,38,.868,4,71,75,43,10,9,26,20,293
415,Jeff Teague\teaguje01,PG,32,BOS,14,2,265,29,88,.330,10,23,.435,19,65,.292,.386,21,24,.875,4,25,29,34,16,2,15,16,89
416,Garrett Temple\templga01,SG,34,CHI,16,2,425,56,120,.467,28,69,.406,28,51,.549,.583,14,17,.824,6,39,45,29,19,4,21,43,154
417,Tyrell Terry\terryty01,PG,20,DAL,9,0,51,5,15,.333,0,7,.000,5,8,.625,.333,0,1,.000,0,6,6,6,5,0,1,2,10
418,Daniel Theis\theisda01,C,28,BOS,16,12,370,64,101,.634,10,30,.333,54,71,.761,.683,17,23,.739,20,63,83,21,10,16,16,43,155
419,Brodric Thomas\thomabr01,SG,24,HOU,4,0,24,2,7,.286,1,6,.167,1,1,1.000,.357,5,7,.714,1,3,4,4,1,1,4,5,10
420,Matt Thomas\thomama02,SG,26,TOR,8,0,58,10,21,.476,8,14,.571,2,7,.286,.667,2,2,1.000,0,6,6,5,2,0,3,2,30
421,Tristan Thompson\thomptr01,PF,29,BOS,14,14,318,35,76,.461,0,0,,35,76,.461,.461,15,24,.625,37,84,121,11,4,9,15,38,85
422,Sindarius Thornwell\thornsi01,SG,26,NOP,5,1,34,2,7,.286,1,2,.500,1,5,.200,.357,0,0,,0,2,2,1,4,0,0,2,5
423,Matisse Thybulle\thybuma01,SG,23,PHI,15,0,228,17,51,.333,8,33,.242,9,18,.500,.412,3,5,.600,3,17,20,11,18,11,5,28,45
424,Xavier Tillman Sr.\tillmxa01,PF,22,MEM,8,1,166,32,57,.561,2,10,.200,30,47,.638,.579,3,4,.750,9,22,31,13,11,4,3,16,69
425,Obi Toppin\toppiob01,PF,22,NYK,8,0,99,16,41,.390,5,18,.278,11,23,.478,.451,3,5,.600,3,22,25,6,2,5,5,6,40
426,Juan Toscano-Anderson\toscaju01,SG,27,GSW,7,2,98,8,13,.615,3,8,.375,5,5,1.000,.731,3,5,.600,1,20,21,12,2,4,5,11,22
427,Karl-Anthony Towns\townska01,C,25,MIN,4,4,132,29,63,.460,6,16,.375,23,47,.489,.508,24,25,.960,16,34,50,17,2,11,10,11,88
428,Gary Trent Jr.\trentga02,SG,22,POR,14,1,355,60,138,.435,34,80,.425,26,58,.448,.558,8,13,.615,6,16,22,14,6,1,8,22,162
429,P.J. Tucker\tuckepj01,PF,35,HOU,15,15,469,31,64,.484,18,40,.450,13,24,.542,.625,9,11,.818,14,57,71,21,14,12,19,50,89
430,Myles Turner\turnemy01,C,24,IND,15,15,491,77,152,.507,22,66,.333,55,86,.640,.579,41,55,.745,21,84,105,16,21,62,24,50,217
431,Jonas Valančiūnas\valanjo01,C,28,MEM,12,12,321,67,126,.532,4,14,.286,63,112,.563,.548,35,48,.729,32,93,125,21,9,12,27,44,173
432,Denzel Valentine\valende01,SG,27,CHI,13,0,246,36,92,.391,21,53,.396,15,39,.385,.505,2,2,1.000,3,50,53,24,11,1,10,11,95
433,Jarred Vanderbilt\vandeja01,PF,21,MIN,14,5,253,41,67,.612,1,1,1.000,40,66,.606,.619,14,29,.483,23,54,77,22,20,10,12,27,97
434,Fred VanVleet\vanvlfr01,SG,26,TOR,17,17,613,118,287,.411,55,149,.369,63,138,.457,.507,39,46,.848,15,61,76,108,25,9,30,35,330
435,Devin Vassell\vassede01,SG,20,SAS,16,0,297,30,81,.370,17,41,.415,13,40,.325,.475,14,15,.933,11,47,58,22,22,6,3,19,91
436,Gabe Vincent\vincega01,PG,24,MIA,9,5,201,28,84,.333,12,54,.222,16,30,.533,.405,10,12,.833,1,14,15,20,4,1,12,23,78
437,Nikola Vučević\vucevni01,C,30,ORL,18,18,599,171,351,.487,50,115,.435,121,236,.513,.558,31,38,.816,42,157,199,66,22,9,27,33,423
438,Dean Wade\wadede01,PF,24,CLE,14,0,147,11,30,.367,7,20,.350,4,10,.400,.483,2,2,1.000,4,14,18,9,5,1,6,12,31
439,Moritz Wagner\wagnemo01,C,23,WAS,5,0,68,11,17,.647,4,7,.571,7,10,.700,.765,6,8,.750,2,18,20,4,1,0,1,18,32
440,Kemba Walker\walkeke02,PG,30,BOS,4,4,94,24,56,.429,10,29,.345,14,27,.519,.518,10,12,.833,0,13,13,19,9,0,9,7,68
441,Lonnie Walker\walkelo01,SG,22,SAS,17,17,488,77,188,.410,32,84,.381,45,104,.433,.495,26,33,.788,5,51,56,28,10,8,15,37,212
442,John Wall\walljo01,PG,30,HOU,8,8,258,52,117,.444,10,35,.286,42,82,.512,.487,23,28,.821,6,28,34,44,9,7,25,10,137
443,Brad Wanamaker\wanambr01,PG,31,GSW,17,0,277,23,73,.315,7,29,.241,16,44,.364,.363,25,29,.862,4,26,30,44,14,3,14,25,78
444,T.J. Warren\warretj01,SF,27,IND,4,4,117,27,51,.529,0,7,.000,27,44,.614,.529,8,10,.800,2,12,14,5,2,0,4,16,62
445,P.J. Washington\washipj01,PF,22,CHO,17,17,493,75,176,.426,18,59,.305,57,117,.487,.477,40,54,.741,29,84,113,49,16,23,36,49,208
446,Yuta Watanabe\watanyu01,SF,26,TOR,11,0,121,8,31,.258,6,16,.375,2,15,.133,.355,4,4,1.000,9,25,34,4,4,8,5,9,26
447,Tremont Waters\watertr01,PG,23,BOS,6,1,61,5,17,.294,3,8,.375,2,9,.222,.382,4,4,1.000,2,3,5,17,3,0,12,5,17
448,Paul Watson\watsopa01,SF,26,TOR,6,0,17,4,5,.800,3,4,.750,1,1,1.000,1.100,0,0,,1,4,5,0,0,1,0,2,11
449,Russell Westbrook\westbru01,PG,32,WAS,8,8,285,54,146,.370,11,36,.306,43,110,.391,.408,25,39,.641,10,66,76,85,9,2,41,24,144
450,Coby White\whiteco01,PG,20,CHI,17,17,573,94,235,.400,39,109,.358,55,126,.437,.483,32,38,.842,8,76,84,96,8,1,46,46,259
451,Derrick White\whitede01,SG,26,SAS,1,0,23,3,9,.333,1,4,.250,2,5,.400,.389,2,2,1.000,0,1,1,1,0,2,2,1,9
452,Hassan Whiteside\whiteha01,C,31,SAC,9,0,114,23,44,.523,0,0,,23,44,.523,.523,12,24,.500,9,29,38,5,2,10,7,13,58
453,Andrew Wiggins\wiggian01,PF,25,GSW,17,17,544,114,247,.462,35,86,.407,79,161,.491,.532,39,57,.684,22,64,86,38,9,28,27,42,302
454,Grant Williams\willigr01,PF,22,BOS,14,4,250,25,61,.410,11,28,.393,14,33,.424,.500,6,14,.429,16,27,43,11,7,5,13,44,67
455,Kenrich Williams\willike04,PF,26,OKC,16,0,195,22,49,.449,5,15,.333,17,34,.500,.500,8,10,.800,16,25,41,17,8,4,6,23,57
456,Lou Williams\willilo02,PG,34,LAC,15,0,285,47,119,.395,13,37,.351,34,82,.415,.450,25,30,.833,4,22,26,41,9,1,13,12,132
457,Patrick Williams\willipa01,PF,19,CHI,16,16,407,57,124,.460,16,36,.444,41,88,.466,.524,21,26,.808,16,48,64,16,12,11,26,41,151
458,Robert Williams\williro04,C,23,BOS,11,0,171,28,40,.700,0,1,.000,28,39,.718,.700,9,10,.900,26,40,66,7,9,17,13,15,65
459,Zion Williamson\willizi01,PF,20,NOP,14,14,463,129,223,.578,1,5,.200,128,218,.587,.581,68,102,.667,45,65,110,26,14,6,36,34,327
460,D.J. Wilson\wilsodj01,PF,24,MIL,7,0,71,11,26,.423,7,16,.438,4,10,.400,.558,1,2,.500,3,16,19,3,1,2,4,9,30
461,Dylan Windler\windldy01,SF,24,CLE,4,0,69,8,15,.533,4,10,.400,4,5,.800,.667,4,4,1.000,2,10,12,4,5,0,3,4,24
462,Cassius Winston\winstca01,PG,22,WAS,2,0,24,3,8,.375,2,6,.333,1,2,.500,.500,0,0,,0,4,4,3,0,1,1,3,8
463,James Wiseman\wisemja01,C,19,GSW,17,16,359,82,160,.513,6,18,.333,76,142,.535,.531,32,52,.615,21,80,101,11,7,24,27,56,202
464,Christian Wood\woodch01,C,25,HOU,12,12,403,112,212,.528,21,58,.362,91,154,.591,.578,37,55,.673,25,104,129,17,9,21,24,27,282
465,Robert Woodard\woodaro01,SF,21,SAC,5,0,16,6,11,.545,1,3,.333,5,8,.625,.591,0,2,.000,3,5,8,0,0,0,1,0,13
466,Delon Wright\wrighde01,SG,28,DET,17,12,461,54,126,.429,16,42,.381,38,84,.452,.492,32,37,.865,16,56,72,74,18,11,19,19,156
467,Thaddeus Young\youngth01,PF,32,CHI,13,0,314,61,104,.587,4,17,.235,57,87,.655,.606,8,17,.471,24,38,62,47,14,5,26,33,134
468,Trae Young\youngtr01,PG,22,ATL,15,15,500,108,263,.411,31,90,.344,77,173,.445,.470,132,152,.868,15,51,66,131,11,3,65,28,379
469,Cody Zeller\zelleco01,C,28,CHO,4,1,63,9,20,.450,0,6,.000,9,14,.643,.450,8,11,.727,8,13,21,5,3,2,3,5,26
470,Ivica Zubac\zubaciv01,C,23,LAC,17,1,315,50,70,.714,0,0,,50,70,.714,.714,31,38,.816,29,65,94,16,7,16,16,41,131