Rk,Player,Pos,Age,Tm,G,GS,MP,FG,FGA,FG%,3P,3PA,3P%,2P,2PA,2P%,eFG%,FT,FTA,FT%,ORB,DRB,TRB,AST,STL,BLK,TOV,PF,PTS
1,Precious Achiuwa\achiupr01,PF,21,MIA,9,1,157,30,49,.612,0,0,,30,49,.612,.612,15,26,.577,18,30,48,9,2,4,14,25,75
2,Jaylen Adams\adamsja01,PG,24,MIL,1,0,1,0,1,.000,0,1,.000,0,0,,.000,0,0,,0,0,0,0,0,0,0,0,0
3,Steven Adams\adamsst01,C,27,NOP,10,10,309,46,67,.687,0,0,,46,67,.687,.687,13,29,.448,32,54,86,28,14,9,20,21,105
4,Bam Adebayo\adebaba01,C,23,MIA,8,8,243,52,81,.642,0,0,,52,81,.642,.642,35,44,.795,9,63,72,40,8,8,27,21,139
5,LaMarcus Aldridge\aldrila01,C,35,SAS,8,8,235,52,120,.433,10,34,.294,42,86,.488,.475,7,9,.778,9,37,46,22,5,7,10,18,121
6,Ty-Shon Alexander\alexaty01,SG,22,PHO,3,0,8,0,3,.000,0,1,.000,0,2,.000,.000,0,0,,0,1,1,1,0,0,0,1,0
7,Nickeil Alexander-Walker\alexani01,SG,22,NOP,8,1,137,36,77,.468,12,33,.364,24,44,.545,.545,8,8,1.000,2,18,20,11,7,1,10,15,92
8,Grayson Allen\allengr01,SG,25,MEM,10,4,206,20,55,.364,13,40,.325,7,15,.467,.482,15,16,.938,6,16,22,17,11,3,9,8,68
9,Jarrett Allen\allenja01,C,22,BRK,12,5,320,44,65,.677,0,0,,44,65,.677,.677,46,61,.754,38,87,125,20,7,19,22,21,134
10,Kyle Anderson\anderky01,PF,27,MEM,11,11,328,51,126,.405,16,48,.333,35,78,.449,.468,24,30,.800,10,70,80,46,4,7,21,20,142
11,Giannis Antetokounmpo\antetgi01,PF,26,MIL,11,11,343,102,196,.520,16,54,.296,86,142,.606,.561,68,110,.618,18,93,111,61,14,13,39,37,288
12,Kostas Antetokounmpo\antetko01,PF,23,LAL,1,0,8,0,2,.000,0,0,,0,2,.000,.000,0,0,,0,4,4,0,0,2,2,1,0
13,Thanasis Antetokounmpo\antetth01,SF,28,MIL,11,0,119,12,19,.632,1,5,.200,11,14,.786,.658,2,2,1.000,12,12,24,12,3,1,12,19,27
14,Carmelo Anthony\anthoca01,PF,36,POR,10,0,247,37,91,.407,18,41,.439,19,50,.380,.505,31,35,.886,3,31,34,12,8,5,8,23,123
15,Cole Anthony\anthoco01,PG,20,ORL,11,3,256,35,111,.315,6,33,.182,29,78,.372,.342,28,31,.903,11,35,46,34,6,2,17,19,104
16,OG Anunoby\anunoog01,SF,23,TOR,10,10,349,43,95,.453,18,57,.316,25,38,.658,.547,22,31,.710,12,42,54,17,18,6,16,31,126
17,Ryan Arcidiacono\arcidry01,PG,26,CHI,2,0,28,3,9,.333,1,5,.200,2,4,.500,.389,3,3,1.000,0,6,6,4,2,0,0,2,10
18,D.J. Augustin\augusdj01,PG,33,MIL,11,0,201,20,56,.357,15,38,.395,5,18,.278,.491,11,11,1.000,6,8,14,33,5,0,13,6,66
19,Deni Avdija\avdijde01,SF,20,WAS,11,11,255,28,62,.452,16,35,.457,12,27,.444,.581,5,8,.625,4,40,44,24,11,3,7,29,77
20,Deandre Ayton\aytonde01,C,22,PHO,11,11,332,60,106,.566,1,4,.250,59,102,.578,.571,16,25,.640,32,92,124,20,4,11,20,37,137
21,Udoka Azubuike\azubuud01,C,21,UTA,5,0,24,3,4,.750,0,0,,3,4,.750,.750,2,4,.500,1,4,5,0,1,1,0,2,8
22,Dwayne Bacon\bacondw01,SG,25,ORL,11,11,278,43,97,.443,7,23,.304,36,74,.486,.479,9,13,.692,3,30,33,10,4,2,9,18,102
23,Marvin Bagley III\baglema01,PF,21,SAC,12,12,299,56,130,.431,10,29,.345,46,101,.455,.469,24,41,.585,26,68,94,11,4,7,22,32,146
24,LaMelo Ball\ballla01,PG,19,CHO,12,0,304,52,129,.403,18,55,.327,34,74,.459,.473,18,26,.692,21,63,84,71,18,4,24,32,140
25,Lonzo Ball\balllo01,PG,23,NOP,9,9,301,43,109,.394,20,65,.308,23,44,.523,.486,6,10,.600,4,35,39,40,10,6,26,26,112
26,Mo Bamba\bambamo01,C,22,ORL,4,0,33,8,18,.444,2,7,.286,6,11,.545,.500,2,3,.667,5,9,14,2,0,2,2,10,20
27,Desmond Bane\banede01,SG,22,MEM,11,0,245,33,73,.452,19,41,.463,14,32,.438,.582,7,9,.778,5,28,33,11,8,0,12,22,92
28,Harrison Barnes\barneha02,PF,28,SAC,12,12,417,72,139,.518,17,41,.415,55,98,.561,.579,47,59,.797,12,70,82,37,9,3,19,11,208
29,RJ Barrett\barrerj01,SG,20,NYK,12,12,455,73,196,.372,10,54,.185,63,142,.444,.398,40,57,.702,18,71,89,41,10,2,18,26,196
30,Will Barton\bartowi01,SF,30,DEN,11,7,318,49,116,.422,16,42,.381,33,74,.446,.491,14,21,.667,7,40,47,31,13,7,11,17,128
31,Keita Bates-Diop\bateske01,SF,25,SAS,2,0,2,0,1,.000,0,0,,0,1,.000,.000,0,0,,0,0,0,0,0,0,0,0,0
32,Nicolas Batum\batumni01,SF,32,LAC,12,12,349,41,82,.500,23,53,.434,18,29,.621,.640,17,19,.895,14,50,64,36,14,3,8,31,122
33,Aron Baynes\baynear01,C,34,TOR,7,7,135,17,45,.378,3,16,.188,14,29,.483,.411,0,0,,11,29,40,4,1,0,6,17,37
34,Kent Bazemore\bazemke01,SF,31,GSW,9,0,148,18,36,.500,7,15,.467,11,21,.524,.597,3,5,.600,3,22,25,19,6,5,9,16,46
35,Darius Bazley\bazleda01,PF,20,OKC,11,11,328,44,114,.386,14,53,.264,30,61,.492,.447,14,16,.875,9,77,86,16,5,12,19,14,116
36,Bradley Beal\bealbr01,SG,27,WAS,10,10,359,121,245,.494,24,64,.375,97,181,.536,.543,83,95,.874,15,38,53,50,14,7,33,25,349
37,Malik Beasley\beaslma01,SG,24,MIN,11,11,357,82,179,.458,29,75,.387,53,104,.510,.539,29,33,.879,8,44,52,22,6,3,13,14,222
38,DeAndre' Bembry\bembrde01,SF,26,TOR,5,0,18,2,4,.500,0,0,,2,4,.500,.500,0,0,,0,3,3,2,1,1,4,2,4
39,Dāvis Bertāns\bertada01,PF,28,WAS,11,0,264,38,102,.373,31,86,.360,7,16,.438,.525,23,28,.821,6,28,34,15,6,3,6,23,130
40,Patrick Beverley\beverpa01,PG,32,LAC,12,12,317,35,83,.422,24,55,.436,11,28,.393,.566,10,13,.769,17,34,51,23,10,10,11,45,104
41,Saddiq Bey\beysa01,SF,21,DET,10,3,230,32,86,.372,25,58,.431,7,28,.250,.517,16,21,.762,5,39,44,8,5,0,7,17,105
42,Tyler Bey\beyty01,SF,22,DAL,1,0,1,0,1,.000,0,0,,0,1,.000,.000,0,0,,0,0,0,0,0,0,0,0,0
43,Khem Birch\birchkh01,C,28,ORL,11,0,218,31,56,.554,1,1,1.000,30,55,.545,.563,18,20,.900,27,36,63,10,10,4,6,23,81
44,Bismack Biyombo\biyombi01,C,28,CHO,12,11,318,37,66,.561,0,1,.000,37,65,.569,.561,16,34,.471,30,53,83,23,1,18,14,32,90
45,Nemanja Bjelica\bjeline01,PF,32,SAC,10,0,151,21,51,.412,5,21,.238,16,30,.533,.461,19,23,.826,10,26,36,19,0,2,12,20,66
46,Eric Bledsoe\bledser01,SG,31,NOP,9,9,269,38,87,.437,17,45,.378,21,42,.500,.534,13,18,.722,5,24,29,39,10,3,18,15,106
47,Keljin Blevins\blevike01,SF,25,POR,4,0,20,1,6,.167,0,3,.000,1,3,.333,.167,0,0,,0,0,0,4,1,0,3,3,2
48,Bogdan Bogdanovic\bogdabo01,SG,28,ATL,9,2,213,30,78,.385,21,58,.362,9,20,.450,.519,8,9,.889,2,32,34,19,4,1,11,18,89
49,Bojan Bogdanovic\bogdabo02,SF,31,UTA,11,11,334,49,131,.374,25,71,.352,24,60,.400,.469,18,22,.818,7,33,40,18,3,1,15,17,141
50,Bol Bol\bolbo01,PF,21,DEN,6,1,36,3,8,.375,2,5,.400,1,3,.333,.500,0,0,,0,4,4,1,0,2,4,5,8
51,Marques Bolden\boldema01,C,22,CLE,6,0,29,1,3,.333,0,0,,1,3,.333,.333,5,8,.625,3,3,6,0,2,2,2,0,7
52,Jordan Bone\bonejo01,PG,23,ORL,6,0,93,12,25,.480,4,13,.308,8,12,.667,.560,0,0,,3,10,13,10,0,0,1,2,28
53,Isaac Bonga\bongais01,SF,21,WAS,8,4,94,9,14,.643,6,10,.600,3,4,.750,.857,0,1,.000,3,15,18,6,2,3,3,13,24
54,Devin Booker\bookede01,SG,24,PHO,11,11,390,89,183,.486,23,66,.348,66,117,.564,.549,52,64,.813,3,33,36,47,12,4,44,33,253
55,Chris Boucher\bouchch01,C,28,TOR,10,0,222,52,90,.578,17,36,.472,35,54,.648,.672,22,30,.733,19,43,62,9,6,26,6,28,143
56,Avery Bradley\bradlav01,SG,30,MIA,7,1,160,25,51,.490,13,29,.448,12,22,.545,.618,7,9,.778,1,12,13,12,6,1,5,18,70
57,Tony Bradley\bradlto01,C,23,PHI,3,0,55,10,20,.500,0,1,.000,10,19,.526,.500,1,3,.333,13,18,31,3,1,5,1,4,21
58,Jarrell Brantley\brantja01,PF,24,UTA,1,0,6,0,1,.000,0,1,.000,0,0,,.000,0,0,,1,0,1,0,0,1,0,2,0
59,Ignas Brazdeikis\brazdig01,SF,22,NYK,3,0,4,0,1,.000,0,0,,0,1,.000,.000,2,2,1.000,1,1,2,0,0,0,0,0,2
60,Mikal Bridges\bridgmi01,SF,24,PHO,11,11,360,57,113,.504,29,64,.453,28,49,.571,.633,23,26,.885,14,45,59,14,6,13,3,21,166
61,Miles Bridges\bridgmi02,PF,22,CHO,12,0,309,41,93,.441,17,43,.395,24,50,.480,.532,9,9,1.000,14,54,68,21,9,13,23,27,108
62,Malcolm Brogdon\brogdma01,PG,28,IND,11,11,408,93,196,.474,34,75,.453,59,121,.488,.561,28,32,.875,7,38,45,82,19,2,18,19,248
63,Dillon Brooks\brookdi01,SF,25,MEM,11,11,331,70,181,.387,24,75,.320,46,106,.434,.453,19,23,.826,16,30,46,36,16,5,30,39,183
64,Bruce Brown\brownbr01,PG,24,BRK,9,5,137,22,40,.550,1,9,.111,21,31,.677,.563,3,5,.600,8,29,37,11,1,4,13,11,48
65,Jaylen Brown\brownja02,SG,24,BOS,10,10,346,103,191,.539,24,57,.421,79,134,.590,.602,33,43,.767,12,50,62,35,17,7,29,30,263
66,Moses Brown\brownmo01,C,21,OKC,4,0,16,3,5,.600,0,0,,3,5,.600,.600,5,12,.417,2,6,8,1,1,2,0,2,11
67,Sterling Brown\brownst02,SG,25,HOU,9,0,168,23,45,.511,14,30,.467,9,15,.600,.667,2,2,1.000,6,19,25,7,8,0,3,17,62
68,Troy Brown Jr.\browntr01,SF,21,WAS,7,0,123,13,30,.433,6,18,.333,7,12,.583,.533,0,3,.000,5,17,22,8,2,1,5,14,32
69,Jalen Brunson\brunsja01,PG,24,DAL,8,1,153,32,65,.492,7,22,.318,25,43,.581,.546,18,20,.900,0,20,20,28,4,0,14,9,89
70,Thomas Bryant\bryanth01,C,23,WAS,10,10,271,59,91,.648,9,21,.429,50,70,.714,.698,16,24,.667,18,43,61,15,4,8,11,31,143
71,Reggie Bullock\bullore01,SF,29,NYK,10,10,287,33,86,.384,15,45,.333,18,41,.439,.471,4,7,.571,4,42,46,13,6,2,9,28,85
72,Trey Burke\burketr01,PG,28,DAL,9,0,178,30,72,.417,17,39,.436,13,33,.394,.535,10,12,.833,1,11,12,18,5,2,8,17,87
73,Alec Burks\burksal01,SG,29,NYK,3,0,83,17,32,.531,10,15,.667,7,17,.412,.688,18,20,.900,0,11,11,11,3,2,7,10,62
74,Jimmy Butler\butleji01,SF,31,MIA,6,6,174,34,77,.442,0,7,.000,34,70,.486,.442,27,29,.931,10,23,33,32,13,4,11,4,95
75,Bruno Caboclo\cabocbr01,PF,25,HOU,6,0,36,8,17,.471,0,5,.000,8,12,.667,.471,1,2,.500,3,11,14,1,0,2,4,6,17
76,Kentavious Caldwell-Pope\caldwke01,SG,27,LAL,9,9,205,32,60,.533,17,32,.531,15,28,.536,.675,10,11,.909,5,14,19,13,11,3,7,15,91
77,Facundo Campazzo\campafa01,PG,29,DEN,10,0,123,14,34,.412,10,25,.400,4,9,.444,.559,10,13,.769,0,10,10,14,7,1,8,17,48
78,Vlatko Čančar\cancavl01,PF,23,DEN,4,0,10,0,2,.000,0,1,.000,0,1,.000,.000,0,0,,1,0,1,0,1,1,2,0,0
79,Clint Capela\capelca01,C,26,ATL,8,8,211,34,67,.507,0,0,,34,67,.507,.507,12,25,.480,31,72,103,10,5,8,10,14,80
80,Vernon Carey Jr.\careyve01,C,19,CHO,3,0,6,1,3,.333,0,1,.000,1,2,.500,.333,1,2,.500,2,1,3,1,0,1,0,0,3
81,Jevon Carter\carteje01,PG,25,PHO,11,0,145,16,43,.372,6,27,.222,10,16,.625,.442,0,0,,1,16,17,10,7,5,2,18,38
82,Wendell Carter Jr.\cartewe01,C,21,CHI,11,11,297,52,99,.525,3,14,.214,49,85,.576,.540,34,47,.723,24,62,86,30,3,5,20,38,141
83,Michael Carter-Williams\cartemi01,SG,29,ORL,7,2,160,15,44,.341,1,12,.083,14,32,.438,.352,5,6,.833,15,21,36,12,4,4,9,19,36
84,Alex Caruso\carusal01,PG,26,LAL,8,0,139,15,32,.469,11,21,.524,4,11,.364,.641,1,2,.500,3,18,21,16,9,1,11,9,42
85,Willie Cauley-Stein\caulewi01,C,27,DAL,10,4,174,20,32,.625,0,1,.000,20,31,.645,.625,14,21,.667,16,41,57,10,4,7,7,27,54
86,Chris Chiozza\chiozch01,PG,25,BRK,6,0,83,9,36,.250,4,15,.267,5,21,.238,.306,4,6,.667,3,5,8,18,4,3,6,5,26
87,Marquese Chriss\chrisma01,PF,23,GSW,2,0,27,5,14,.357,1,5,.200,4,9,.444,.393,2,4,.500,3,10,13,2,0,2,2,3,13
88,Gary Clark\clarkga01,SF,26,ORL,8,2,158,7,27,.259,5,22,.227,2,5,.400,.352,1,1,1.000,10,21,31,5,3,1,8,12,20
89,Brandon Clarke\clarkbr01,PF,24,MEM,11,7,316,64,134,.478,6,24,.250,58,110,.527,.500,10,23,.435,18,45,63,19,10,9,9,18,144
90,Jordan Clarkson\clarkjo01,SG,28,UTA,11,0,267,72,144,.500,31,71,.437,41,73,.562,.608,14,15,.933,13,37,50,18,11,3,23,15,189
91,Amir Coffey\coffeam01,SG,23,LAC,8,0,37,4,12,.333,2,6,.333,2,6,.333,.417,2,3,.667,1,1,2,3,0,0,0,2,12
92,John Collins\collijo01,PF,23,ATL,10,10,281,63,115,.548,13,33,.394,50,82,.610,.604,28,35,.800,25,52,77,15,6,7,11,34,167
93,Mike Conley\conlemi01,PG,33,UTA,11,11,333,66,146,.452,34,79,.430,32,67,.478,.568,24,31,.774,11,36,47,62,12,1,25,22,190
94,Pat Connaughton\connapa01,SG,28,MIL,9,0,148,21,44,.477,16,30,.533,5,14,.357,.659,2,2,1.000,7,25,32,9,6,4,1,10,60
95,Quinn Cook\cookqu01,PG,27,LAL,9,0,33,7,14,.500,4,8,.500,3,6,.500,.643,4,5,.800,0,2,2,3,1,0,1,1,22
96,DeMarcus Cousins\couside01,C,30,HOU,7,1,94,16,45,.356,6,17,.353,10,28,.357,.422,10,14,.714,8,35,43,11,5,8,7,13,48
97,Robert Covington\covinro01,PF,30,POR,11,11,339,26,74,.351,19,56,.339,7,18,.389,.480,7,8,.875,6,60,66,19,15,5,13,32,78
98,Torrey Craig\craigto01,SF,30,MIL,2,0,13,0,1,.000,0,0,,0,1,.000,.000,0,0,,0,4,4,2,0,1,1,2,0
99,Jae Crowder\crowdja01,PF,30,PHO,11,11,317,36,89,.404,25,71,.352,11,18,.611,.545,12,14,.857,4,50,54,25,7,1,7,26,109
100,Jarrett Culver\culveja01,SG,21,MIN,11,7,247,33,75,.440,5,22,.227,28,53,.528,.473,10,19,.526,21,41,62,12,6,3,16,25,81
101,Seth Curry\curryse01,SG,30,PHI,8,8,240,47,78,.603,25,42,.595,22,36,.611,.763,17,17,1.000,1,17,18,29,6,3,12,14,136
102,Stephen Curry\curryst01,PG,32,GSW,11,11,377,96,223,.430,45,122,.369,51,101,.505,.531,69,74,.932,9,47,56,70,13,2,34,25,306
103,Anthony Davis\davisan02,PF,27,LAL,11,11,350,97,171,.567,13,33,.394,84,138,.609,.605,36,47,.766,20,74,94,32,12,19,21,16,243
104,Ed Davis\davised01,C,31,MIN,8,4,111,8,21,.381,0,0,,8,21,.381,.381,3,4,.750,19,25,44,6,3,4,2,18,19
105,Terence Davis\daviste02,SG,23,TOR,7,0,85,18,39,.462,9,22,.409,9,17,.529,.577,5,5,1.000,1,10,11,8,3,1,6,9,50
106,DeMar DeRozan\derozde01,SF,31,SAS,9,9,310,65,133,.489,9,23,.391,56,110,.509,.523,52,60,.867,6,44,50,63,8,6,12,20,191
107,Hamidou Diallo\diallha01,SG,22,OKC,11,0,231,52,92,.565,4,12,.333,48,80,.600,.587,26,37,.703,9,47,56,19,11,4,13,24,134
108,Gorgui Dieng\dienggo01,C,31,MEM,9,0,153,28,54,.519,10,24,.417,18,30,.600,.611,7,7,1.000,11,30,41,14,9,5,10,14,73
109,Spencer Dinwiddie\dinwisp01,SG,27,BRK,3,3,64,6,16,.375,2,7,.286,4,9,.444,.438,6,6,1.000,0,13,13,9,2,1,5,4,20
110,Donte DiVincenzo\divindo01,SG,24,MIL,12,12,300,48,106,.453,26,59,.441,22,47,.468,.575,6,8,.750,10,40,50,31,18,3,15,14,128
111,Luka Doncic\doncilu01,PG,21,DAL,9,9,307,87,187,.465,18,66,.273,69,121,.570,.513,55,71,.775,8,78,86,75,11,9,40,14,247
112,Luguentz Dort\dortlu01,SG,21,OKC,11,11,303,45,98,.459,24,54,.444,21,44,.477,.582,19,24,.792,8,30,38,9,8,3,13,28,133
113,Damyean Dotson\dotsoda01,SG,26,CLE,11,5,279,38,88,.432,13,46,.283,25,42,.595,.506,6,11,.545,2,14,16,32,8,2,10,10,95
114,Devon Dotson\dotsode01,PG,21,CHI,1,0,10,2,4,.500,0,0,,2,4,.500,.500,0,0,,0,1,1,0,0,0,0,1,4
115,Sekou Doumbouya\doumbse01,PF,20,DET,10,0,114,14,42,.333,7,16,.438,7,26,.269,.417,8,9,.889,6,18,24,5,4,2,2,11,43
116,PJ Dozier\doziepj01,SG,24,DEN,11,0,219,27,65,.415,9,24,.375,18,41,.439,.485,8,12,.667,13,36,49,13,3,8,10,21,71
117,Goran Dragić\dragigo01,PG,34,MIA,8,0,188,42,83,.506,14,37,.378,28,46,.609,.590,20,23,.870,4,14,18,40,5,0,22,19,118
118,Andre Drummond\drumman01,C,27,CLE,11,11,347,84,180,.467,0,6,.000,84,174,.483,.467,30,58,.517,46,120,166,32,18,17,43,33,198
119,Jared Dudley\dudleja01,PF,35,LAL,6,0,22,1,1,1.000,1,1,1.000,0,0,,1.500,0,0,,1,5,6,1,0,0,0,0,3
120,Kevin Durant\duranke01,PF,32,BRK,9,9,309,87,162,.537,24,52,.462,63,110,.573,.611,67,78,.859,4,61,65,52,7,8,33,18,265
121,Anthony Edwards\edwaran01,SG,19,MIN,11,0,272,53,140,.379,16,60,.267,37,80,.463,.436,16,21,.762,12,20,32,21,6,2,20,19,138
122,Carsen Edwards\edwarca01,SG,22,BOS,4,0,29,6,15,.400,1,5,.200,5,10,.500,.433,0,0,,1,2,3,2,0,1,1,3,13
123,CJ Elleby\ellebcj01,SF,20,POR,5,0,29,4,7,.571,1,4,.250,3,3,1.000,.643,2,3,.667,1,1,2,2,0,1,1,6,11
124,Wayne Ellington\ellinwa01,SG,33,DET,6,3,97,18,39,.462,10,27,.370,8,12,.667,.590,1,1,1.000,3,8,11,3,2,3,2,8,47
125,Joel Embiid\embiijo01,C,26,PHI,10,10,320,87,160,.544,12,31,.387,75,129,.581,.581,80,93,.860,18,103,121,31,14,16,32,22,266
126,James Ennis\ennisja01,SF,30,ORL,4,3,72,7,18,.389,1,5,.200,6,13,.462,.417,4,4,1.000,3,6,9,5,5,0,5,5,19
127,Drew Eubanks\eubandr01,PF,23,SAS,3,0,58,3,13,.231,0,0,,3,13,.231,.231,3,4,.750,1,12,13,1,1,6,1,7,9
128,Dante Exum\exumda01,SG,25,CLE,6,3,116,10,26,.385,2,11,.182,8,15,.533,.423,1,2,.500,2,15,17,13,4,2,7,9,23
129,Tacko Fall\fallta01,C,25,BOS,2,0,25,2,4,.500,0,0,,2,4,.500,.500,2,4,.500,3,5,8,0,0,5,0,4,6
130,Derrick Favors\favorde01,C,29,UTA,11,0,182,30,50,.600,0,0,,30,50,.600,.600,9,14,.643,22,45,67,13,3,13,5,28,69
131,Cristiano Felício\feliccr01,C,28,CHI,1,0,6,0,1,.000,0,0,,0,1,.000,.000,0,2,.000,2,1,3,2,0,0,0,0,0
132,Terrance Ferguson\fergute01,SG,22,PHI,4,0,15,0,3,.000,0,3,.000,0,0,,.000,0,0,,0,1,1,1,0,0,0,2,0
133,Bruno Fernando\fernabr01,C,22,ATL,7,0,86,5,13,.385,0,2,.000,5,11,.455,.385,2,5,.400,9,27,36,6,2,1,9,9,12
134,Yogi Ferrell\ferreyo01,G,27,CLE,2,0,40,8,21,.381,3,9,.333,5,12,.417,.452,0,2,.000,3,4,7,5,3,1,3,4,19
135,Dorian Finney-Smith\finnedo01,PF,27,DAL,8,8,235,27,65,.415,14,43,.326,13,22,.591,.523,6,7,.857,11,29,40,8,11,5,4,24,74
136,Malachi Flynn\flynnma01,PG,22,TOR,6,0,53,5,20,.250,2,11,.182,3,9,.333,.300,0,0,,0,6,6,6,1,0,1,5,12
137,Bryn Forbes\forbebr01,SG,27,MIL,12,0,208,36,77,.468,20,46,.435,16,31,.516,.597,6,10,.600,1,11,12,4,4,0,11,16,98
138,Trent Forrest\forretr01,PG,22,UTA,2,0,9,0,0,,0,0,,0,0,,,2,2,1.000,0,0,0,1,1,0,0,2,2
139,Evan Fournier\fournev01,SF,28,ORL,5,5,127,23,45,.511,8,23,.348,15,22,.682,.600,20,23,.870,2,6,8,10,7,0,9,13,74
140,De'Aaron Fox\foxde01,PG,23,SAC,12,12,367,80,179,.447,16,46,.348,64,133,.481,.492,54,76,.711,8,28,36,65,17,9,36,29,230
141,Tim Frazier\fraziti01,PG,30,MEM,3,0,33,2,8,.250,0,2,.000,2,6,.333,.250,0,0,,0,4,4,7,1,0,3,4,4
142,Markelle Fultz\fultzma01,PG,22,ORL,8,8,215,41,104,.394,4,16,.250,37,88,.420,.413,17,19,.895,5,20,25,43,8,2,18,18,103
143,Daniel Gafford\gaffoda01,PF,22,CHI,10,0,139,19,27,.704,0,0,,19,27,.704,.704,13,20,.650,10,12,22,6,7,11,6,19,51
144,Danilo Gallinari\gallida01,PF,32,ATL,2,1,28,6,8,.750,2,3,.667,4,5,.800,.875,4,4,1.000,0,5,5,3,0,0,3,2,18
145,Langston Galloway\gallola01,SG,29,PHO,11,0,105,17,37,.459,13,27,.481,4,10,.400,.635,7,7,1.000,3,7,10,4,0,0,2,4,54
146,Darius Garland\garlada01,PG,21,CLE,6,6,215,40,88,.455,15,32,.469,25,56,.446,.540,8,9,.889,3,17,20,38,8,2,18,19,103
147,Marc Gasol\gasolma01,C,36,LAL,13,13,256,18,39,.462,7,20,.350,11,19,.579,.551,14,16,.875,13,55,68,28,7,21,18,36,57
148,Rudy Gay\gayru01,PF,34,SAS,11,0,254,51,118,.432,19,57,.333,32,61,.525,.513,8,11,.727,10,47,57,17,8,10,11,23,129
149,Paul George\georgpa01,SF,30,LAC,11,11,386,90,181,.497,47,91,.516,43,90,.478,.627,50,55,.909,7,62,69,60,15,6,43,23,277
150,Harry Giles\gilesha01,C,22,POR,7,0,52,6,14,.429,2,3,.667,4,11,.364,.500,4,6,.667,2,18,20,4,2,5,5,13,18
151,Shai Gilgeous-Alexander\gilgesh01,SG,22,OKC,11,11,363,79,162,.488,19,54,.352,60,108,.556,.546,49,64,.766,10,49,59,64,10,5,30,25,226
152,Anthony Gill\gillan01,PF,28,WAS,4,0,14,2,3,.667,1,2,.500,1,1,1.000,.833,2,2,1.000,0,3,3,0,1,0,0,2,7
153,Rudy Gobert\goberru01,C,28,UTA,11,11,334,52,94,.553,0,0,,52,94,.553,.553,24,50,.480,37,110,147,16,6,29,20,23,128
154,Brandon Goodwin\goodwbr01,PG,25,ATL,8,0,119,17,45,.378,8,24,.333,9,21,.429,.467,4,6,.667,1,11,12,18,4,0,3,6,46
155,Aaron Gordon\gordoaa01,PF,25,ORL,10,10,272,55,114,.482,15,42,.357,40,72,.556,.548,23,38,.605,13,53,66,28,9,7,20,16,148
156,Eric Gordon\gordoer01,SG,32,HOU,7,1,179,33,76,.434,16,54,.296,17,22,.773,.539,18,20,.900,2,13,15,11,7,6,11,13,100
157,Devonte' Graham\grahade01,PG,25,CHO,12,12,394,44,148,.297,27,90,.300,17,58,.293,.389,25,31,.806,6,32,38,79,20,0,13,20,140
158,Jerami Grant\grantje01,SF,26,DET,11,11,404,93,204,.456,30,78,.385,63,126,.500,.529,57,66,.864,12,54,66,20,11,13,17,30,273
159,Danny Green\greenda02,SF,33,PHI,12,12,336,39,108,.361,29,81,.358,10,27,.370,.495,7,10,.700,16,26,42,33,16,8,22,25,114
160,Draymond Green\greendr01,PF,30,GSW,7,7,190,9,30,.300,3,15,.200,6,15,.400,.350,10,13,.769,3,33,36,46,9,2,14,21,31
161,JaMychal Green\greenja01,PF,30,DEN,7,0,144,28,54,.519,16,32,.500,12,22,.545,.667,8,12,.667,11,34,45,9,4,0,15,16,80
162,Javonte Green\greenja02,SG,27,BOS,3,0,43,6,11,.545,1,4,.250,5,7,.714,.591,3,5,.600,4,4,8,2,3,0,2,1,16
163,Jeff Green\greenje02,PF,34,BRK,13,6,271,30,54,.556,14,31,.452,16,23,.696,.685,5,7,.714,6,29,35,14,7,2,9,21,79
164,Josh Green\greenjo02,SG,20,DAL,8,1,66,4,9,.444,0,3,.000,4,6,.667,.444,3,6,.500,5,9,14,3,0,0,4,4,11
165,Blake Griffin\griffbl01,PF,31,DET,8,8,257,36,94,.383,18,57,.316,18,37,.486,.479,19,28,.679,3,44,47,34,8,0,13,11,109
166,Kyle Guy\guyky01,PG,23,SAC,4,0,34,4,14,.286,2,5,.400,2,9,.222,.357,5,6,.833,0,5,5,7,1,0,0,0,15
167,Rui Hachimura\hachiru01,PF,22,WAS,7,7,194,35,70,.500,4,13,.308,31,57,.544,.529,21,28,.750,6,26,32,16,4,1,5,17,95
168,Tyrese Haliburton\halibty01,PG,20,SAC,10,1,289,46,85,.541,25,48,.521,21,37,.568,.688,9,11,.818,8,21,29,57,13,4,13,13,126
169,Josh Hall\halljo01,SF,20,OKC,4,0,26,1,11,.091,1,6,.167,0,5,.000,.136,0,2,.000,1,3,4,4,0,0,1,5,3
170,R.J. Hampton\hamptrj01,PG,19,DEN,8,0,16,3,5,.600,0,1,.000,3,4,.750,.600,0,0,,1,1,2,0,0,0,1,2,6
171,Tim Hardaway Jr.\hardati02,SG,28,DAL,10,8,307,64,140,.457,38,90,.422,26,50,.520,.593,18,28,.643,1,37,38,23,8,2,12,14,184
172,James Harden\hardeja01,SG,31,HOU,8,8,290,60,135,.444,25,72,.347,35,63,.556,.537,53,60,.883,5,36,41,83,7,6,34,14,198
173,Maurice Harkless\harklma01,SF,27,MIA,6,2,49,1,6,.167,1,4,.250,0,2,.000,.250,0,2,.000,0,5,5,1,0,0,2,7,3
174,Jared Harper\harpeja01,PG,23,NYK,2,0,5,0,1,.000,0,0,,0,1,.000,.000,2,2,1.000,0,0,0,0,0,0,2,0,2
175,Montrezl Harrell\harremo01,C,27,LAL,13,0,318,71,117,.607,0,4,.000,71,113,.628,.607,35,48,.729,38,60,98,12,7,7,16,26,177
176,Gary Harris\harriga01,SG,26,DEN,10,10,317,42,91,.462,11,41,.268,31,50,.620,.522,11,15,.733,6,17,23,14,10,3,8,20,106
177,Jalen Harris\harrija01,SG,22,TOR,1,0,2,0,0,,0,0,,0,0,,,0,0,,0,0,0,0,0,0,0,1,0
178,Joe Harris\harrijo01,SF,29,BRK,13,10,376,73,140,.521,38,76,.500,35,64,.547,.657,4,8,.500,11,36,47,28,9,4,13,31,188
179,Tobias Harris\harrito02,PF,28,PHI,9,9,296,68,134,.507,21,47,.447,47,87,.540,.586,14,17,.824,13,58,71,28,10,9,20,20,171
180,Shaquille Harrison\harrish01,SG,27,UTA,5,0,22,4,7,.571,0,0,,4,7,.571,.571,1,2,.500,0,1,1,4,2,0,3,1,9
181,Josh Hart\hartjo01,SF,25,NOP,10,1,292,27,66,.409,13,40,.325,14,26,.538,.508,15,23,.652,10,73,83,14,9,1,9,21,82
182,Isaiah Hartenstein\harteis01,C,22,DEN,9,0,89,18,33,.545,0,0,,18,33,.545,.545,8,15,.533,17,13,30,7,4,8,11,23,44
183,Jaxson Hayes\hayesja02,C,20,NOP,10,0,119,11,23,.478,0,0,,11,23,.478,.478,7,9,.778,15,27,42,7,2,5,6,17,29
184,Killian Hayes\hayeski01,PG,19,DET,7,7,148,13,47,.277,5,20,.250,8,27,.296,.330,1,2,.500,1,7,8,25,2,0,17,15,32
185,Gordon Hayward\haywago01,SF,30,CHO,12,12,410,97,198,.490,26,63,.413,71,135,.526,.556,44,48,.917,8,53,61,45,15,5,25,26,264
186,Juan Hernangómez\hernaju01,PF,25,MIN,11,6,224,27,68,.397,12,39,.308,15,29,.517,.485,7,10,.700,10,48,58,6,5,2,4,10,73
187,Willy Hernangómez\hernawi01,C,26,NOP,1,0,7,0,1,.000,0,0,,0,1,.000,.000,1,4,.250,0,4,4,1,0,0,0,0,1
188,Tyler Herro\herroty01,SG,21,MIA,9,9,305,60,127,.472,15,51,.294,45,76,.592,.531,24,31,.774,1,60,61,35,3,1,25,15,159
189,Buddy Hield\hieldbu01,SG,28,SAC,12,12,412,64,173,.370,47,127,.370,17,46,.370,.506,13,16,.813,3,49,52,35,8,4,20,37,188
190,George Hill\hillge01,PG,34,OKC,10,10,255,42,83,.506,15,40,.375,27,43,.628,.596,18,20,.900,6,16,22,35,10,2,9,11,117
191,Solomon Hill\hillso01,PF,29,ATL,10,0,176,18,49,.367,16,40,.400,2,9,.222,.531,3,3,1.000,6,23,29,6,6,4,6,20,55
192,Nate Hinton\hintona01,SG,21,DAL,2,0,2,0,1,.000,0,1,.000,0,0,,.000,0,0,,0,0,0,0,0,0,0,0,0
193,Aaron Holiday\holidaa01,PG,24,IND,11,6,235,27,76,.355,10,36,.278,17,40,.425,.421,5,6,.833,4,12,16,27,12,2,8,26,69
194,Jrue Holiday\holidjr01,PG,30,MIL,12,12,378,70,143,.490,21,54,.389,49,89,.551,.563,21,25,.840,12,40,52,60,26,8,17,26,182
195,Justin Holiday\holidju01,SG,31,IND,11,2,327,41,79,.519,19,45,.422,22,34,.647,.639,16,22,.727,7,33,40,13,13,3,11,28,117
196,Richaun Holmes\holmeri01,C,27,SAC,11,11,315,62,89,.697,1,2,.500,61,87,.701,.702,24,29,.828,32,54,86,23,11,16,14,47,149
197,Rodney Hood\hoodro01,SF,28,POR,9,0,120,6,29,.207,3,13,.231,3,16,.188,.259,0,0,,0,10,10,14,6,2,6,9,15
198,Al Horford\horfoal01,C,34,OKC,9,9,244,41,98,.418,16,50,.320,25,48,.521,.500,2,4,.500,5,59,64,22,3,7,8,14,100
199,Talen Horton-Tucker\hortota01,SG,20,LAL,12,0,200,33,77,.429,8,29,.276,25,48,.521,.481,15,18,.833,7,23,30,26,11,6,13,24,89
200,Danuel House\houseda01,SF,27,HOU,4,4,130,10,27,.370,3,15,.200,7,12,.583,.426,7,10,.700,1,17,18,9,1,1,1,10,30
201,Dwight Howard\howardw01,C,35,PHI,12,2,195,33,49,.673,3,6,.500,30,43,.698,.704,12,22,.545,24,63,87,9,2,8,22,39,81
202,Markus Howard\howarma02,SG,21,DEN,5,0,7,1,5,.200,0,4,.000,1,1,1.000,.200,0,0,,0,0,0,1,0,0,0,1,2
203,Kevin Huerter\huertke01,SG,22,ATL,10,0,272,44,104,.423,23,60,.383,21,44,.477,.534,7,8,.875,11,25,36,33,11,1,11,25,118
204,Elijah Hughes\hugheel01,SF,22,UTA,5,0,22,4,14,.286,3,10,.300,1,4,.250,.393,3,4,.750,0,4,4,2,1,1,3,0,14
205,De'Andre Hunter\huntede01,SF,23,ATL,10,10,316,57,110,.518,20,46,.435,37,64,.578,.609,29,34,.853,12,56,68,21,6,6,10,29,163
206,Chandler Hutchison\hutchch01,SF,24,CHI,4,0,52,5,16,.313,1,3,.333,4,13,.308,.344,2,2,1.000,1,16,17,4,1,0,3,7,13
207,Serge Ibaka\ibakase01,C,31,LAC,12,12,307,60,118,.508,13,37,.351,47,81,.580,.564,14,18,.778,19,59,78,19,3,14,16,27,147
208,Andre Iguodala\iguodan01,SF,37,MIA,8,2,147,13,38,.342,11,28,.393,2,10,.200,.487,0,0,,4,21,25,16,5,3,8,13,37
209,Joe Ingles\inglejo01,SF,33,UTA,9,0,233,33,70,.471,16,45,.356,17,25,.680,.586,7,9,.778,5,32,37,29,3,1,15,18,89
210,Brandon Ingram\ingrabr01,SF,23,NOP,10,10,350,80,179,.447,20,58,.345,60,121,.496,.503,58,67,.866,10,60,70,55,6,9,28,11,238
211,Kyrie Irving\irvinky01,PG,28,BRK,7,7,231,71,141,.504,26,61,.426,45,80,.563,.596,22,22,1.000,5,32,37,43,11,2,15,18,190
212,Wesley Iwundu\iwundwe01,SF,26,DAL,6,1,79,7,19,.368,1,7,.143,6,12,.500,.395,3,4,.750,1,10,11,2,3,0,2,5,18
213,Frank Jackson\jacksfr01,PG,22,DET,3,0,24,2,10,.200,2,8,.250,0,2,.000,.300,0,0,,0,4,4,5,1,0,3,3,6
214,Josh Jackson\jacksjo02,SG,23,DET,9,6,202,43,99,.434,12,40,.300,31,59,.525,.495,13,19,.684,5,27,32,16,10,4,14,24,111
215,Justin Jackson\jacksju01,SF,25,OKC,4,1,57,7,19,.368,1,12,.083,6,7,.857,.395,5,6,.833,1,8,9,3,1,0,5,3,20
216,Reggie Jackson\jacksre01,SG,30,LAC,10,0,135,22,47,.468,10,26,.385,12,21,.571,.574,2,5,.400,1,14,15,20,4,1,5,14,56
217,Justin James\jamesju01,SF,24,SAC,4,0,29,3,9,.333,0,4,.000,3,5,.600,.333,1,7,.143,1,4,5,3,1,0,0,0,7
218,LeBron James\jamesle01,PG,36,LAL,13,13,415,116,240,.483,32,83,.386,84,157,.535,.550,52,74,.703,10,95,105,97,10,5,46,16,316
219,Isaiah Joe\joeis01,SG,21,PHI,7,1,137,15,44,.341,11,33,.333,4,11,.364,.466,5,5,1.000,4,12,16,11,4,3,3,14,46
220,Cameron Johnson\johnsca02,PF,24,PHO,11,0,255,48,102,.471,28,73,.384,20,29,.690,.608,12,14,.857,3,32,35,16,6,6,6,11,136
221,James Johnson\johnsja01,PF,33,DAL,10,0,171,19,47,.404,6,21,.286,13,26,.500,.468,8,16,.500,5,28,33,20,15,6,9,17,52
222,Keldon Johnson\johnske04,SF,21,SAS,11,11,353,54,121,.446,13,35,.371,41,86,.477,.500,28,34,.824,18,63,81,26,14,8,18,30,149
223,Stanley Johnson\johnsst04,PF,24,TOR,8,0,107,7,20,.350,2,9,.222,5,11,.455,.400,1,2,.500,8,19,27,10,9,1,5,10,17
224,Tyler Johnson\johnsty01,SG,28,BRK,4,0,30,3,7,.429,3,5,.600,0,2,.000,.643,0,0,,1,1,2,7,3,0,0,1,9
225,Nikola Jokic\jokicni01,C,25,DEN,11,11,385,99,172,.576,14,34,.412,85,138,.616,.616,55,67,.821,28,92,120,115,20,6,46,35,267
226,Damian Jones\jonesda03,C,25,PHO,5,0,42,3,6,.500,0,1,.000,3,5,.600,.500,2,5,.400,4,5,9,0,1,3,3,9,8
227,Derrick Jones Jr.\jonesde02,SF,23,POR,11,11,296,25,62,.403,8,28,.286,17,34,.500,.468,14,24,.583,13,26,39,8,13,7,6,31,72
228,Mason Jones\jonesma05,SG,22,HOU,3,0,22,3,9,.333,1,5,.200,2,4,.500,.389,3,6,.500,2,5,7,3,1,0,1,2,10
229,Tre Jones\jonestr01,PG,21,SAS,3,0,10,4,7,.571,0,0,,4,7,.571,.571,3,3,1.000,3,0,3,1,0,0,0,0,11
230,Tyus Jones\jonesty01,PG,24,MEM,11,8,297,40,96,.417,7,31,.226,33,65,.508,.453,5,7,.714,4,27,31,63,17,3,12,5,92
231,DeAndre Jordan\jordade01,C,32,BRK,12,8,217,23,29,.793,0,0,,23,29,.793,.793,8,16,.500,17,66,83,21,2,15,21,28,54
232,Cory Joseph\josepco01,PG,29,SAC,12,0,264,32,75,.427,8,27,.296,24,48,.500,.480,16,21,.762,5,24,29,31,8,5,15,32,88
233,Mfiondu Kabengele\kabenmf01,PF,23,LAC,7,0,33,1,9,.111,1,6,.167,0,3,.000,.167,2,2,1.000,0,4,4,2,2,1,2,7,5
234,Frank Kaminsky\kaminfr01,C,27,PHO,5,0,40,7,18,.389,1,4,.250,6,14,.429,.417,2,4,.500,5,4,9,4,0,1,1,3,17
235,Enes Kanter\kanteen01,C,28,POR,11,0,209,49,74,.662,0,0,,49,74,.662,.662,18,23,.783,37,61,98,4,6,6,10,20,116
236,Luke Kennard\kennalu01,SG,24,LAC,12,3,273,35,74,.473,18,38,.474,17,36,.472,.595,8,9,.889,2,30,32,19,3,3,16,20,96
237,Maxi Kleber\klebima01,PF,29,DAL,9,3,219,18,41,.439,16,34,.471,2,7,.286,.634,15,16,.938,7,41,48,12,3,8,6,17,67
238,Nathan Knight\knighna01,PF,23,ATL,6,0,35,5,15,.333,3,7,.429,2,8,.250,.433,4,5,.800,6,4,10,1,0,3,3,5,17
239,Kevin Knox\knoxke01,SF,21,NYK,12,0,264,37,84,.440,20,48,.417,17,36,.472,.560,6,8,.750,7,26,33,11,4,6,14,22,100
240,John Konchar\konchjo01,SG,24,MEM,5,0,98,10,23,.435,3,8,.375,7,15,.467,.500,6,6,1.000,5,18,23,14,7,2,1,6,29
241,Furkan Korkmaz\korkmfu01,SG,23,PHI,3,0,55,6,24,.250,4,16,.250,2,8,.250,.333,2,2,1.000,0,6,6,3,2,2,6,2,18
242,Luke Kornet\kornelu01,PF,25,CHI,1,0,7,0,2,.000,0,2,.000,0,0,,.000,2,2,1.000,0,1,1,0,1,0,1,0,2
243,Rodions Kurucs\kurucro01,PF,22,BRK,5,0,16,1,3,.333,1,2,.500,0,1,.000,.500,0,0,,0,3,3,2,0,0,0,1,3
244,Kyle Kuzma\kuzmaky01,SF,25,LAL,13,4,325,54,122,.443,23,61,.377,31,61,.508,.537,6,9,.667,13,46,59,16,3,10,21,25,137
245,Zach LaVine\lavinza01,SG,25,CHI,11,11,387,107,218,.491,36,97,.371,71,121,.587,.573,55,62,.887,3,53,56,51,14,7,45,32,305
246,Jake Layman\laymaja01,SF,26,MIN,9,3,127,14,32,.438,2,12,.167,12,20,.600,.469,13,15,.867,0,7,7,6,7,4,4,14,43
247,Jalen Lecque\lecquja01,PG,20,IND,2,0,4,1,2,.500,0,0,,1,2,.500,.500,1,1,1.000,1,2,3,1,0,0,0,0,3
248,Damion Lee\leeda03,SG,28,GSW,11,0,210,27,57,.474,21,46,.457,6,11,.545,.658,8,9,.889,6,32,38,15,8,0,4,19,83
249,Saben Lee\leesa01,PG,21,DET,2,0,25,3,9,.333,0,1,.000,3,8,.375,.333,2,4,.500,1,0,1,1,3,0,3,2,8
250,Alex Len\lenal01,C,27,TOR,7,2,76,5,10,.500,3,6,.500,2,4,.500,.650,3,6,.500,0,11,11,3,1,6,8,10,16
251,Kawhi Leonard\leonaka01,SF,29,LAC,10,10,351,88,188,.468,21,48,.438,67,140,.479,.524,51,59,.864,11,39,50,60,20,8,20,21,248
252,Meyers Leonard\leoname01,C,28,MIA,3,2,29,3,7,.429,3,7,.429,0,0,,.643,1,2,.500,0,7,7,2,0,0,2,5,10
253,Caris LeVert\leverca01,SG,26,BRK,12,4,334,87,200,.435,22,63,.349,65,137,.474,.490,26,34,.765,10,42,52,72,13,6,26,20,222
254,Kira Lewis Jr.\lewiski01,PG,19,NOP,3,0,28,5,13,.385,2,5,.400,3,8,.375,.462,2,2,1.000,0,2,2,1,1,1,1,2,14
255,Damian Lillard\lillada01,PG,30,POR,11,11,393,92,208,.442,43,114,.377,49,94,.521,.546,74,80,.925,2,48,50,77,11,3,30,13,301
256,Nassir Little\littlna01,PF,20,POR,2,0,13,2,3,.667,1,1,1.000,1,2,.500,.833,0,0,,1,2,3,0,0,1,1,2,5
257,Kevon Looney\looneke01,C,24,GSW,11,0,157,18,28,.643,0,2,.000,18,26,.692,.643,8,11,.727,12,27,39,16,4,2,10,22,44
258,Brook Lopez\lopezbr01,C,32,MIL,12,12,312,39,93,.419,22,61,.361,17,32,.531,.538,10,11,.909,18,40,58,11,8,20,9,26,110
259,Robin Lopez\lopezro01,C,32,WAS,11,1,178,28,45,.622,2,5,.400,26,40,.650,.644,13,25,.520,20,26,46,6,1,6,7,23,71
260,Kevin Love\loveke01,PF,32,CLE,2,2,46,6,18,.333,3,9,.333,3,9,.333,.417,4,5,.800,2,10,12,5,1,0,3,1,19
261,Kyle Lowry\lowryky01,PG,34,TOR,9,9,328,53,130,.408,26,76,.342,27,54,.500,.508,39,45,.867,8,46,54,60,10,0,28,33,171
262,Timothé Luwawu-Cabarrot\luwawti01,SF,25,BRK,13,4,268,42,97,.433,23,63,.365,19,34,.559,.552,12,15,.800,6,23,29,16,7,2,11,26,119
263,Trey Lyles\lylestr01,PF,25,SAS,6,2,83,6,16,.375,2,7,.286,4,9,.444,.438,2,5,.400,5,21,26,3,0,0,0,3,16
264,Thon Maker\makerth01,C,23,CLE,8,0,76,10,18,.556,0,2,.000,10,16,.625,.556,10,11,.909,8,10,18,4,2,4,3,7,30
265,Théo Maledon\maledth01,PG,19,OKC,11,0,225,25,69,.362,11,38,.289,14,31,.452,.442,5,11,.455,3,19,22,32,7,0,21,22,66
266,Karim Mané\maneka01,PG,20,ORL,5,0,50,0,7,.000,0,1,.000,0,6,.000,.000,4,4,1.000,0,10,10,1,0,1,3,1,4
267,Terance Mann\mannte01,SG,24,LAC,10,0,79,7,21,.333,0,3,.000,7,18,.389,.333,0,0,,4,13,17,5,0,2,4,10,14
268,Nico Mannion\mannini01,PG,19,GSW,1,0,8,0,2,.000,0,1,.000,0,1,.000,.000,0,0,,0,2,2,2,0,0,0,1,0
269,Boban Marjanović\marjabo01,C,32,DAL,7,0,61,17,28,.607,0,2,.000,17,26,.654,.607,4,6,.667,10,12,22,0,0,0,1,6,38
270,Lauri Markkanen\markkla01,PF,23,CHI,4,4,106,22,44,.500,11,23,.478,11,21,.524,.625,14,18,.778,4,23,27,5,3,1,7,6,69
271,Caleb Martin\martica02,SF,25,CHO,11,0,167,31,61,.508,8,26,.308,23,35,.657,.574,6,11,.545,7,19,26,15,9,3,7,7,76
272,Cody Martin\martico01,SF,25,CHO,10,0,120,15,28,.536,2,10,.200,13,18,.722,.571,6,8,.750,8,16,24,14,5,0,6,6,38
273,Kelan Martin\martike03,SF,25,IND,4,0,23,2,11,.182,0,4,.000,2,7,.286,.182,0,0,,1,5,6,0,2,0,2,4,4
274,Kenyon Martin Jr.\martike04,SF,20,HOU,3,0,14,3,8,.375,1,2,.500,2,6,.333,.438,0,0,,2,1,3,3,1,0,0,0,7
275,Garrison Mathews\mathega01,SG,24,WAS,5,0,64,12,27,.444,8,17,.471,4,10,.400,.593,8,9,.889,4,4,8,5,4,1,1,9,40
276,Dakota Mathias\mathida01,SG,25,PHI,7,2,121,19,47,.404,8,25,.320,11,22,.500,.489,2,6,.333,1,6,7,12,1,3,1,7,48
277,Wesley Matthews\matthwe02,SG,34,LAL,10,1,221,21,45,.467,16,39,.410,5,6,.833,.644,3,4,.750,4,10,14,11,4,4,1,15,61
278,Tyrese Maxey\maxeyty01,SG,20,PHI,12,3,252,60,126,.476,9,29,.310,51,97,.526,.512,3,5,.600,3,28,31,32,8,3,10,17,132
279,Skylar Mays\mayssk01,SG,23,ATL,3,0,11,0,3,.000,0,1,.000,0,2,.000,.000,0,0,,0,0,0,1,0,0,0,1,0
280,CJ McCollum\mccolcj01,SG,29,POR,11,11,387,109,231,.472,55,126,.437,54,105,.514,.591,36,43,.837,6,42,48,60,16,3,12,24,309
281,T.J. McConnell\mccontj01,PG,28,IND,8,0,136,14,26,.538,0,2,.000,14,24,.583,.538,1,2,.500,4,19,23,35,12,0,11,12,29
282,Jaden McDaniels\mcdanja02,PF,20,MIN,5,0,37,6,11,.545,4,8,.500,2,3,.667,.727,1,2,.500,2,6,8,4,2,1,3,5,17
283,Jalen McDaniels\mcdanja01,SF,23,CHO,9,0,83,13,25,.520,2,6,.333,11,19,.579,.560,7,11,.636,3,16,19,5,2,0,8,13,35
284,Doug McDermott\mcderdo01,PF,29,IND,11,0,258,45,91,.495,19,50,.380,26,41,.634,.599,16,21,.762,9,31,40,10,3,0,9,22,125
285,Sean McDermott\mcderse01,SF,24,MEM,3,0,42,2,7,.286,1,5,.200,1,2,.500,.357,2,2,1.000,2,1,3,3,0,0,3,1,7
286,JaVale McGee\mcgeeja01,C,33,CLE,12,1,207,41,90,.456,4,10,.400,37,80,.463,.478,16,26,.615,26,54,80,16,7,13,14,33,102
287,Rodney McGruder\mcgruro01,SG,29,DET,2,0,12,1,1,1.000,0,0,,1,1,1.000,1.000,1,1,1.000,1,0,1,0,0,0,0,1,3
288,Alfonzo McKinnie\mckinal01,SF,28,LAL,8,0,27,8,10,.800,3,3,1.000,5,7,.714,.950,2,2,1.000,3,4,7,0,0,0,1,1,21
289,Jordan McLaughlin\mclaujo01,PG,24,MIN,4,0,64,7,17,.412,2,7,.286,5,10,.500,.471,0,0,,1,6,7,14,2,1,3,1,16
290,Ben McLemore\mclembe01,SG,27,HOU,3,0,49,11,21,.524,10,17,.588,1,4,.250,.762,0,0,,0,7,7,4,2,0,6,5,32
291,Nicolò Melli\mellini01,PF,30,NOP,7,0,80,4,17,.235,3,14,.214,1,3,.333,.324,3,4,.750,2,14,16,8,3,0,4,7,14
292,De'Anthony Melton\meltode01,PG,22,MEM,6,0,126,23,48,.479,6,15,.400,17,33,.515,.542,1,2,.500,1,14,15,16,8,6,9,11,53
293,Sam Merrill\merrisa01,SG,24,MIL,7,0,43,4,8,.500,4,6,.667,0,2,.000,.750,2,2,1.000,3,6,9,10,1,0,3,3,14
294,Chimezie Metu\metuch01,C,23,SAC,3,0,15,5,8,.625,1,1,1.000,4,7,.571,.688,4,5,.800,3,0,3,1,1,2,1,1,15
295,Khris Middleton\middlkh01,SF,29,MIL,12,12,383,98,180,.544,32,68,.471,66,112,.589,.633,31,33,.939,11,65,76,68,11,3,31,31,259
296,Darius Miller\milleda01,SF,30,OKC,2,0,7,1,3,.333,1,3,.333,0,0,,.500,0,0,,0,0,0,0,0,0,1,1,3
297,Patty Mills\millspa02,PG,32,SAS,11,0,281,58,121,.479,35,74,.473,23,47,.489,.624,16,17,.941,2,15,17,36,3,1,8,19,167
298,Paul Millsap\millspa01,PF,35,DEN,11,11,264,42,81,.519,16,36,.444,26,45,.578,.617,19,27,.704,10,36,46,14,7,2,15,23,119
299,Shake Milton\miltosh01,SG,24,PHI,9,1,233,44,96,.458,11,40,.275,33,56,.589,.516,28,34,.824,2,13,15,30,9,2,13,19,127
300,Donovan Mitchell\mitchdo01,SG,24,UTA,11,11,369,91,218,.417,37,98,.378,54,120,.450,.502,38,48,.792,10,29,39,54,7,4,33,18,257
301,Adam Mokoka\mokokad01,SG,22,CHI,5,0,39,5,14,.357,1,8,.125,4,6,.667,.393,0,0,,1,3,4,4,2,1,2,5,11
302,Malik Monk\monkma01,SG,22,CHO,2,0,11,0,2,.000,0,2,.000,0,0,,.000,1,2,.500,0,0,0,3,0,0,1,0,1
303,E'Twaun Moore\mooreet01,SG,31,PHO,2,0,9,1,4,.250,0,1,.000,1,3,.333,.250,0,0,,1,0,1,0,0,0,2,2,2
304,Ja Morant\moranja01,PG,21,MEM,3,3,81,30,55,.545,3,9,.333,27,46,.587,.573,16,19,.842,2,5,7,19,2,2,7,6,79
305,Juwan Morgan\morgaju01,PF,23,UTA,3,0,10,0,1,.000,0,1,.000,0,0,,.000,0,0,,0,3,3,0,0,0,0,1,0
306,Marcus Morris\morrima03,PF,31,LAC,4,0,81,11,32,.344,7,17,.412,4,15,.267,.453,4,4,1.000,4,10,14,3,0,0,6,8,33
307,Markieff Morris\morrima02,PF,31,LAL,13,1,200,22,52,.423,12,35,.343,10,17,.588,.538,4,5,.800,9,46,55,11,1,5,6,21,60
308,Monte Morris\morrimo01,PG,25,DEN,11,1,284,47,89,.528,14,37,.378,33,52,.635,.607,17,25,.680,3,21,24,35,10,3,3,10,125
309,Mychal Mulder\muldemy01,PG,26,GSW,11,0,117,15,32,.469,12,28,.429,3,4,.750,.656,4,7,.571,0,11,11,5,2,1,4,10,46
310,Dejounte Murray\murrade01,PG,24,SAS,11,11,358,72,162,.444,12,37,.324,60,125,.480,.481,22,27,.815,10,67,77,58,12,1,22,25,178
311,Jamal Murray\murraja01,PG,23,DEN,10,10,350,72,151,.477,24,62,.387,48,89,.539,.556,29,38,.763,7,22,29,38,9,1,20,24,197
312,Mike Muscala\muscami01,C,29,OKC,10,0,177,32,71,.451,20,51,.392,12,20,.600,.592,8,9,.889,2,30,32,8,2,4,5,16,92
313,Sviatoslav Mykhailiuk\mykhasv01,SF,23,DET,11,0,192,31,83,.373,20,65,.308,11,18,.611,.494,15,16,.938,1,16,17,12,8,2,4,8,97
314,Abdel Nader\naderab01,SF,27,PHO,1,0,3,0,0,,0,0,,0,0,,,2,2,1.000,0,1,1,1,0,0,0,0,2
315,Larry Nance Jr.\nancela02,PF,28,CLE,12,11,418,47,97,.485,19,45,.422,28,52,.538,.582,9,16,.563,17,53,70,44,29,6,22,23,122
316,Aaron Nesmith\nesmiaa01,SF,21,BOS,3,0,39,3,12,.250,2,9,.222,1,3,.333,.333,0,0,,1,4,5,1,0,1,2,7,8
317,Raul Neto\netora01,PG,28,WAS,11,4,186,39,74,.527,14,33,.424,25,41,.610,.622,6,9,.667,3,11,14,18,11,0,9,16,98
318,Georges Niang\niangge01,PF,27,UTA,11,0,102,11,30,.367,5,20,.250,6,10,.600,.450,0,0,,2,17,19,2,1,0,3,8,27
319,Zeke Nnaji\nnajize01,PF,20,DEN,5,0,11,1,4,.250,0,2,.000,1,2,.500,.250,0,0,,1,1,2,0,0,0,0,1,2
320,Nerlens Noel\noelne01,C,26,NYK,10,0,144,13,24,.542,0,0,,13,24,.542,.542,3,5,.600,14,29,43,4,8,12,14,17,29
321,Jaylen Nowell\nowelja01,SG,21,MIN,1,0,8,1,3,.333,0,1,.000,1,2,.500,.333,0,0,,1,0,1,1,0,0,0,0,2
322,Frank Ntilikina\ntilila01,PG,22,NYK,4,0,42,6,14,.429,5,9,.556,1,5,.200,.607,1,3,.333,1,3,4,3,3,0,2,7,18
323,Kendrick Nunn\nunnke01,PG,25,MIA,5,0,61,11,29,.379,1,9,.111,10,20,.500,.397,3,3,1.000,1,4,5,9,2,1,3,2,26
324,Jusuf Nurkić\nurkiju01,C,26,POR,11,11,260,48,95,.505,2,9,.222,46,86,.535,.516,15,27,.556,21,63,84,31,11,10,21,31,113
325,David Nwaba\nwabada01,SF,28,HOU,8,7,185,24,55,.436,5,21,.238,19,34,.559,.482,8,17,.471,3,16,19,3,6,7,4,15,61
326,Jordan Nwora\nworajo01,SF,22,MIL,8,0,71,16,32,.500,7,14,.500,9,18,.500,.609,9,10,.900,1,14,15,0,4,1,8,9,48
327,Royce O'Neale\onealro01,SF,27,UTA,11,11,348,28,57,.491,21,45,.467,7,12,.583,.675,3,6,.500,16,67,83,23,9,4,12,27,80
328,Semi Ojeleye\ojelese01,PF,26,BOS,9,1,156,19,44,.432,11,27,.407,8,17,.471,.557,5,9,.556,8,21,29,5,0,0,5,11,54
329,Jahlil Okafor\okafoja01,C,25,DET,8,0,84,19,28,.679,0,0,,19,28,.679,.679,0,0,,11,12,23,2,2,1,4,8,38
330,Chuma Okeke\okekech01,PF,22,ORL,5,0,91,5,14,.357,2,7,.286,3,7,.429,.429,3,6,.500,5,8,13,8,3,1,3,2,15
331,Josh Okogie\okogijo01,SG,22,MIN,5,4,122,14,28,.500,1,8,.125,13,20,.650,.518,4,6,.667,5,12,17,9,0,5,4,13,33
332,Isaac Okoro\okorois01,SG,20,CLE,7,7,252,22,56,.393,6,20,.300,16,36,.444,.446,6,12,.500,5,10,15,14,7,2,12,19,56
333,KZ Okpala\okpalkz01,PF,21,MIA,4,0,41,2,8,.250,0,4,.000,2,4,.500,.250,1,4,.250,3,5,8,1,2,0,1,3,5
334,Victor Oladipo\oladivi01,SG,28,IND,9,9,300,64,152,.421,25,69,.362,39,83,.470,.503,27,37,.730,1,50,51,38,15,2,18,23,180
335,Kelly Olynyk\olynyke01,C,29,MIA,8,4,228,35,74,.473,22,55,.400,13,19,.684,.622,4,6,.667,6,40,46,19,9,7,12,21,96
336,Miye Oni\onimi01,SG,23,UTA,6,0,45,3,9,.333,3,7,.429,0,2,.000,.500,0,0,,1,8,9,5,0,4,1,8,9
337,Cedi Osman\osmande01,SF,25,CLE,12,6,353,52,147,.354,25,83,.301,27,64,.422,.439,16,22,.727,7,39,46,43,11,3,18,31,145
338,Daniel Oturu\oturuda01,C,21,LAC,5,0,23,5,8,.625,0,1,.000,5,7,.714,.625,0,0,,1,6,7,2,0,2,1,3,10
339,Kelly Oubre Jr.\oubreke01,SF,25,GSW,11,11,295,47,133,.353,10,58,.172,37,75,.493,.391,15,19,.789,17,44,61,10,14,10,20,24,119
340,Eric Paschall\pascher01,PF,24,GSW,10,2,193,45,83,.542,7,18,.389,38,65,.585,.584,24,29,.828,9,23,32,13,3,2,4,18,121
341,Anžejs Pasečņiks\pasecan01,C,25,WAS,1,0,6,0,1,.000,0,1,.000,0,0,,.000,0,0,,1,0,1,1,0,0,5,2,0
342,Patrick Patterson\pattepa01,PF,31,LAC,5,0,57,5,14,.357,3,10,.300,2,4,.500,.464,2,2,1.000,3,7,10,3,2,0,3,7,15
343,Chris Paul\paulch01,PG,35,PHO,11,11,348,53,122,.434,8,28,.286,45,94,.479,.467,32,33,.970,7,44,51,96,8,3,18,33,146
344,Cameron Payne\payneca01,PG,26,PHO,9,0,160,28,56,.500,9,21,.429,19,35,.543,.580,4,4,1.000,2,20,22,39,6,1,12,20,69
345,Elfrid Payton\paytoel01,PG,26,NYK,12,12,359,70,158,.443,9,27,.333,61,131,.466,.472,18,28,.643,17,36,53,54,7,2,28,28,167
346,Reggie Perry\perryre01,PF,20,BRK,5,0,42,8,16,.500,1,5,.200,7,11,.636,.531,1,3,.333,3,10,13,4,0,0,3,4,18
347,Theo Pinson\pinsoth01,SG,25,NYK,5,0,12,0,4,.000,0,4,.000,0,0,,.000,0,0,,0,1,1,0,0,0,0,0,0
348,Mason Plumlee\plumlma01,C,30,DET,11,11,295,32,64,.500,0,4,.000,32,60,.533,.500,21,27,.778,36,68,104,40,17,6,17,37,85
349,Jakob Poeltl\poeltja01,C,25,SAS,11,3,209,22,42,.524,0,0,,22,42,.524,.524,3,13,.231,26,38,64,21,6,5,10,18,47
350,Vincent Poirier\poirivi01,C,27,PHI,3,0,14,1,3,.333,0,0,,1,3,.333,.333,2,4,.500,2,1,3,1,0,1,1,1,4
351,Aleksej Pokusevski\pokusal01,PF,19,OKC,9,0,148,12,45,.267,5,27,.185,7,18,.389,.322,0,0,,4,33,37,10,5,11,14,9,29
352,Jordan Poole\poolejo01,SG,21,GSW,6,0,71,12,29,.414,5,17,.294,7,12,.583,.500,9,9,1.000,1,7,8,5,1,0,4,7,38
353,Michael Porter Jr.\portemi01,SF,22,DEN,4,4,117,30,53,.566,11,26,.423,19,27,.704,.670,7,8,.875,5,22,27,7,4,6,2,11,78
354,Otto Porter\porteot01,SF,27,CHI,10,6,235,42,96,.438,20,48,.417,22,48,.458,.542,24,27,.889,14,49,63,20,8,0,10,17,128
355,Bobby Portis\portibo01,C,25,MIL,12,1,289,59,105,.562,11,27,.407,48,78,.615,.614,12,15,.800,25,68,93,15,12,6,15,26,141
356,Kristaps Porzingis\porzikr01,C,25,DAL,1,1,21,6,16,.375,4,9,.444,2,7,.286,.500,0,0,,0,4,4,0,0,2,0,3,16
357,Dwight Powell\poweldw01,C,29,DAL,9,6,178,14,30,.467,1,5,.200,13,25,.520,.483,16,22,.727,10,22,32,11,11,5,8,23,45
358,Norman Powell\powelno01,SG,27,TOR,10,3,229,31,84,.369,18,42,.429,13,42,.310,.476,25,29,.862,0,18,18,6,11,2,11,19,105
359,Taurean Prince\princta02,PF,26,BRK,12,4,218,30,74,.405,13,37,.351,17,37,.459,.493,24,27,.889,2,32,34,7,8,8,11,21,97
360,Payton Pritchard\pritcpa01,SG,23,BOS,10,0,229,33,64,.516,11,26,.423,22,38,.579,.602,9,10,.900,5,19,24,31,13,3,19,20,86
361,Immanuel Quickley\quickim01,PG,21,NYK,8,0,134,17,53,.321,7,24,.292,10,29,.345,.387,18,19,.947,0,12,12,15,5,2,7,14,59
362,Jahmi'us Ramsey\ramseja01,SG,19,SAC,4,0,16,2,4,.500,1,3,.333,1,1,1.000,.625,0,0,,0,4,4,1,0,1,1,0,5
363,Julius Randle\randlju01,PF,26,NYK,12,12,448,100,201,.498,16,47,.340,84,154,.545,.537,57,73,.781,17,113,130,81,8,3,50,42,273
364,Cam Reddish\reddica01,SF,21,ATL,10,9,285,37,106,.349,15,52,.288,22,54,.407,.420,25,30,.833,7,39,46,12,14,2,15,25,114
365,JJ Redick\redicjj01,SG,36,NOP,10,0,218,24,74,.324,15,51,.294,9,23,.391,.426,15,15,1.000,1,17,18,12,3,0,6,18,78
366,Paul Reed\reedpa01,PF,21,PHI,3,0,48,7,17,.412,0,2,.000,7,15,.467,.412,0,0,,7,3,10,3,1,4,4,3,14
367,Naz Reid\reidna01,C,21,MIN,11,3,215,44,81,.543,11,29,.379,33,52,.635,.611,20,28,.714,11,36,47,13,4,11,15,33,119
368,Nick Richards\richani01,PF,23,CHO,4,0,12,2,2,1.000,0,0,,2,2,1.000,1.000,1,2,.500,1,3,4,0,0,0,0,2,5
369,Josh Richardson\richajo01,SG,27,DAL,8,8,260,39,95,.411,16,50,.320,23,45,.511,.495,16,17,.941,9,14,23,13,7,2,10,30,110
370,Austin Rivers\riverau01,SG,28,NYK,8,2,230,36,75,.480,20,45,.444,16,30,.533,.613,0,0,,3,20,23,22,5,0,12,14,92
371,Duncan Robinson\robindu01,SF,26,MIA,9,9,288,35,86,.407,31,78,.397,4,8,.500,.587,15,19,.789,0,38,38,13,7,3,13,16,116
372,Glenn Robinson III\robingl02,SF,27,SAC,9,0,170,22,45,.489,8,20,.400,14,25,.560,.578,13,14,.929,3,18,21,11,0,1,3,8,65
373,Jerome Robinson\robinje01,SG,23,WAS,6,1,90,9,23,.391,4,10,.400,5,13,.385,.478,5,5,1.000,0,10,10,8,3,0,4,13,27
374,Mitchell Robinson\robinmi01,C,22,NYK,12,12,364,50,75,.667,0,0,,50,75,.667,.667,8,17,.471,47,54,101,7,17,23,10,30,108
375,Isaiah Roby\robyis01,PF,22,OKC,8,2,142,26,42,.619,5,12,.417,21,30,.700,.679,9,16,.563,12,25,37,7,1,4,9,16,66
376,Rajon Rondo\rondora01,PG,34,ATL,2,0,31,5,10,.500,2,5,.400,3,5,.600,.600,0,0,,1,1,2,14,1,1,2,1,12
377,Derrick Rose\rosede01,PG,32,DET,8,0,189,41,102,.402,6,21,.286,35,81,.432,.431,23,28,.821,3,13,16,43,8,3,19,11,111
378,Terrence Ross\rosste01,SG,29,ORL,10,0,273,56,126,.444,22,55,.400,34,71,.479,.532,31,34,.912,3,21,24,15,14,2,18,18,165
379,Terry Rozier\roziete01,SG,26,CHO,12,12,389,80,172,.465,39,90,.433,41,82,.500,.578,34,44,.773,6,39,45,31,17,6,23,28,233
380,Ricky Rubio\rubiori01,PG,30,MIN,11,3,269,24,63,.381,5,21,.238,19,42,.452,.421,16,17,.941,4,27,31,59,15,0,18,24,69
381,D'Angelo Russell\russeda01,PG,24,MIN,11,10,346,85,195,.436,31,80,.388,54,115,.470,.515,27,39,.692,6,29,35,60,14,4,38,25,228
382,Domantas Sabonis\sabondo01,PF,24,IND,11,11,415,95,171,.556,9,24,.375,86,147,.585,.582,41,60,.683,33,105,138,64,6,6,40,43,240
383,Luka Šamanić\samanlu01,PF,21,SAS,3,0,8,1,5,.200,1,2,.500,0,3,.000,.300,1,2,.500,0,0,0,0,0,0,0,0,4
384,JaKarr Sampson\sampsja02,PF,27,IND,6,0,40,6,11,.545,0,2,.000,6,9,.667,.545,3,3,1.000,2,8,10,0,1,2,1,6,15
385,Dario Saric\saricda01,PF,26,PHO,7,0,132,26,58,.448,10,28,.357,16,30,.533,.534,12,13,.923,3,29,32,7,4,1,11,14,74
386,Tomas Satoranský\satorto01,SG,29,CHI,3,0,68,7,15,.467,2,6,.333,5,9,.556,.533,3,3,1.000,2,5,7,18,4,1,8,2,19
387,Dennis Schroder\schrode01,SG,27,LAL,13,13,402,70,163,.429,16,43,.372,54,120,.450,.479,29,37,.784,6,47,53,63,11,3,32,35,185
388,Mike Scott\scottmi01,PF,32,PHI,7,2,148,14,44,.318,9,36,.250,5,8,.625,.420,2,3,.667,4,16,20,1,2,2,3,9,39
389,Collin Sexton\sextoco01,SG,22,CLE,8,8,299,78,147,.531,16,31,.516,62,116,.534,.585,29,35,.829,4,13,17,28,11,2,17,23,201
390,Landry Shamet\shamela01,SG,23,BRK,13,0,231,21,63,.333,14,47,.298,7,16,.438,.444,14,16,.875,2,18,20,16,9,1,11,15,70
391,Pascal Siakam\siakapa01,PF,26,TOR,9,9,323,69,149,.463,13,42,.310,56,107,.523,.507,33,44,.750,22,57,79,46,7,5,23,38,184
392,Chris Silva\silvach01,PF,24,MIA,4,0,27,1,2,.500,0,0,,1,2,.500,.500,5,6,.833,6,7,13,5,0,1,5,9,7
393,Ben Simmons\simmobe01,PG,24,PHI,10,10,326,48,93,.516,1,2,.500,47,91,.516,.522,29,48,.604,8,77,85,75,15,11,38,34,126
394,Anfernee Simons\simonan01,SG,21,POR,8,0,83,13,36,.361,10,26,.385,3,10,.300,.500,4,6,.667,0,13,13,4,1,2,2,9,40
395,Deividas Sirvydis\sirvyde01,SG,20,DET,1,0,1,0,0,,0,0,,0,0,,,0,0,,0,0,0,0,0,0,0,0,0
396,Marcus Smart\smartma01,PG,26,BOS,9,9,301,31,88,.352,17,47,.362,14,41,.341,.449,31,40,.775,6,19,25,58,14,6,16,23,110
397,Dennis Smith Jr.\smithde03,PG,23,NYK,2,0,24,2,8,.250,0,3,.000,2,5,.400,.250,4,4,1.000,0,2,2,3,3,0,1,4,8
398,Ish Smith\smithis01,PG,32,WAS,11,0,212,28,71,.394,4,12,.333,24,59,.407,.423,5,13,.385,6,31,37,44,7,3,11,12,65
399,Jalen Smith\smithja04,PF,20,PHO,2,0,20,2,5,.400,0,1,.000,2,4,.500,.400,0,2,.000,3,2,5,1,0,1,1,1,4
400,Tony Snell\snellto01,SG,29,ATL,1,0,7,0,3,.000,0,2,.000,0,1,.000,.000,0,0,,0,0,0,0,0,0,0,2,0
401,Cassius Stanley\stanlca01,SG,21,IND,4,0,9,2,3,.667,1,1,1.000,1,2,.500,.833,2,2,1.000,1,1,2,0,0,0,1,2,7
402,Lamar Stevens\stevela01,PF,23,CLE,8,0,108,13,32,.406,1,6,.167,12,26,.462,.422,6,8,.750,2,13,15,3,4,0,3,5,33
403,Isaiah Stewart\stewais01,C,19,DET,9,0,152,17,37,.459,0,1,.000,17,36,.472,.459,4,7,.571,26,20,46,6,3,7,5,22,38
404,Max Strus\strusma01,SF,24,MIA,2,0,36,6,12,.500,3,9,.333,3,3,1.000,.625,0,0,,0,1,1,2,0,0,0,1,15
405,Edmond Sumner\sumneed01,SG,25,IND,4,1,51,11,17,.647,1,5,.200,10,12,.833,.676,1,3,.333,2,5,7,2,2,0,4,3,24
406,Jae'Sean Tate\tateja01,SF,25,HOU,9,0,213,28,51,.549,4,14,.286,24,37,.649,.588,11,16,.688,11,26,37,11,8,3,10,25,71
407,Jayson Tatum\tatumja01,SF,22,BOS,10,10,346,101,213,.474,35,80,.438,66,133,.496,.556,32,36,.889,4,67,71,38,10,8,24,18,269
408,Jeff Teague\teaguje01,PG,32,BOS,8,1,159,18,54,.333,7,13,.538,11,41,.268,.398,13,16,.813,4,17,21,21,12,2,8,13,56
409,Garrett Temple\templga01,SG,34,CHI,10,1,265,31,66,.470,18,44,.409,13,22,.591,.606,7,9,.778,6,19,25,18,10,2,13,28,87
410,Tyrell Terry\terryty01,PG,20,DAL,5,0,16,1,5,.200,0,3,.000,1,2,.500,.200,0,1,.000,0,2,2,2,1,0,1,1,2
411,Daniel Theis\theisda01,C,28,BOS,10,10,225,33,60,.550,5,21,.238,28,39,.718,.592,3,9,.333,11,34,45,14,4,10,11,23,74
412,Brodric Thomas\thomabr01,SG,24,HOU,3,0,19,1,5,.200,0,4,.000,1,1,1.000,.200,3,5,.600,1,2,3,4,0,0,3,5,5
413,Matt Thomas\thomama02,SG,26,TOR,4,0,49,8,18,.444,7,13,.538,1,5,.200,.639,1,1,1.000,0,5,5,5,2,0,1,2,24
414,Tristan Thompson\thomptr01,PF,29,BOS,8,8,185,27,51,.529,0,0,,27,51,.529,.529,13,20,.650,25,43,68,6,2,6,10,22,67
415,Sindarius Thornwell\thornsi01,SG,26,NOP,3,1,29,1,5,.200,0,1,.000,1,4,.250,.200,0,0,,0,2,2,0,4,0,0,2,2
416,Matisse Thybulle\thybuma01,SG,23,PHI,9,0,113,7,22,.318,3,14,.214,4,8,.500,.386,1,1,1.000,1,8,9,8,7,5,2,10,18
417,Xavier Tillman Sr.\tillmxa01,PF,22,MEM,6,0,109,20,36,.556,0,3,.000,20,33,.606,.556,2,2,1.000,7,14,21,10,5,4,1,10,42
418,Obi Toppin\toppiob01,PF,22,NYK,2,0,25,3,12,.250,3,7,.429,0,5,.000,.375,0,0,,0,3,3,1,0,2,0,0,9
419,Juan Toscano-Anderson\toscaju01,SG,27,GSW,6,2,90,7,9,.778,2,4,.500,5,5,1.000,.889,3,5,.600,1,19,20,11,2,4,5,10,19
420,Karl-Anthony Towns\townska01,C,25,MIN,4,4,132,29,63,.460,6,16,.375,23,47,.489,.508,24,25,.960,16,34,50,17,2,11,10,11,88
421,Gary Trent Jr.\trentga02,SG,22,POR,9,0,217,36,79,.456,22,47,.468,14,32,.438,.595,8,12,.667,2,13,15,11,4,1,4,13,102
422,P.J. Tucker\tuckepj01,PF,35,HOU,9,9,284,17,34,.500,13,25,.520,4,9,.444,.691,3,5,.600,8,32,40,12,11,8,12,29,50
423,Myles Turner\turnemy01,C,24,IND,11,11,342,51,103,.495,15,48,.313,36,55,.655,.568,21,28,.750,16,56,72,13,17,46,13,39,138
424,Jonas Valanciunas\valanjo01,C,28,MEM,11,11,301,64,120,.533,4,13,.308,60,107,.561,.550,32,42,.762,31,87,118,20,9,11,26,39,164
425,Denzel Valentine\valende01,SG,27,CHI,8,0,149,22,48,.458,13,30,.433,9,18,.500,.594,2,2,1.000,2,32,34,13,8,1,4,6,59
426,Jarred Vanderbilt\vandeja01,PF,21,MIN,9,0,134,19,29,.655,0,0,,19,29,.655,.655,9,19,.474,12,34,46,12,10,4,6,15,47
427,Fred VanVleet\vanvlfr01,SG,26,TOR,10,10,358,78,173,.451,35,90,.389,43,83,.518,.552,18,22,.818,10,35,45,58,13,6,16,20,209
428,Devin Vassell\vassede01,SG,20,SAS,10,0,156,13,40,.325,8,19,.421,5,21,.238,.425,3,3,1.000,5,26,31,12,10,3,3,10,37
429,Gabe Vincent\vincega01,PG,24,MIA,2,1,52,11,26,.423,6,17,.353,5,9,.556,.538,3,4,.750,0,4,4,5,2,0,2,7,31
430,Nikola Vučević\vucevni01,C,30,ORL,11,11,346,100,199,.503,28,66,.424,72,133,.541,.573,20,26,.769,25,99,124,38,11,5,13,13,248
431,Dean Wade\wadede01,PF,24,CLE,11,0,136,11,30,.367,7,20,.350,4,10,.400,.483,2,2,1.000,3,14,17,7,5,1,5,10,31
432,Moritz Wagner\wagnemo01,C,23,WAS,5,0,68,11,17,.647,4,7,.571,7,10,.700,.765,6,8,.750,2,18,20,4,1,0,1,18,32
433,Lonnie Walker\walkelo01,SG,22,SAS,11,11,322,57,131,.435,21,52,.404,36,79,.456,.515,20,26,.769,5,29,34,20,7,7,10,24,155
434,John Wall\walljo01,PG,30,HOU,7,7,237,49,108,.454,10,31,.323,39,77,.506,.500,22,26,.846,5,28,33,36,9,7,24,9,130
435,Brad Wanamaker\wanambr01,PG,31,GSW,11,0,173,14,46,.304,6,18,.333,8,28,.286,.370,18,21,.857,3,19,22,30,10,2,8,17,52
436,T.J. Warren\warretj01,SF,27,IND,4,4,117,27,51,.529,0,7,.000,27,44,.614,.529,8,10,.800,2,12,14,5,2,0,4,16,62
437,P.J. Washington\washipj01,PF,22,CHO,12,12,338,50,121,.413,15,41,.366,35,80,.438,.475,32,44,.727,21,56,77,36,12,16,23,38,147
438,Yuta Watanabe\watanyu01,SF,26,TOR,5,0,58,4,15,.267,3,7,.429,1,8,.125,.367,0,0,,4,13,17,2,1,5,3,7,11
439,Tremont Waters\watertr01,PG,23,BOS,3,1,33,2,10,.200,1,4,.250,1,6,.167,.250,4,4,1.000,1,1,2,8,2,0,7,4,9
440,Paul Watson\watsopa01,SF,26,TOR,3,0,8,1,2,.500,0,1,.000,1,1,1.000,.500,0,0,,1,2,3,0,0,1,0,1,2
441,Russell Westbrook\westbru01,PG,32,WAS,7,7,260,51,135,.378,10,33,.303,41,102,.402,.415,23,35,.657,7,61,68,79,9,2,37,23,135
442,Coby White\whiteco01,PG,20,CHI,11,11,383,69,164,.421,27,76,.355,42,88,.477,.503,25,30,.833,6,51,57,68,3,1,33,26,190
443,Derrick White\whitede01,SG,26,SAS,1,0,23,3,9,.333,1,4,.250,2,5,.400,.389,2,2,1.000,0,1,1,1,0,2,2,1,9
444,Hassan Whiteside\whiteha01,C,31,SAC,9,0,114,23,44,.523,0,0,,23,44,.523,.523,12,24,.500,9,29,38,5,2,10,7,13,58
445,Andrew Wiggins\wiggian01,PF,25,GSW,11,11,358,72,167,.431,24,61,.393,48,106,.453,.503,29,40,.725,11,42,53,27,5,20,24,27,197
446,Grant Williams\willigr01,PF,22,BOS,8,0,153,18,40,.450,7,17,.412,11,23,.478,.538,2,5,.400,11,18,29,6,5,5,7,25,45
447,Kenrich Williams\willike04,PF,26,OKC,11,0,118,10,27,.370,3,9,.333,7,18,.389,.426,6,6,1.000,7,15,22,11,4,4,6,17,29
448,Lou Williams\willilo02,PG,34,LAC,12,0,236,41,94,.436,10,26,.385,31,68,.456,.489,20,25,.800,3,20,23,31,8,1,10,11,112
449,Patrick Williams\willipa01,PF,19,CHI,11,11,291,42,89,.472,11,24,.458,31,65,.477,.534,18,21,.857,8,30,38,11,11,8,18,28,113
450,Robert Williams\williro04,C,23,BOS,8,0,131,24,31,.774,0,1,.000,24,30,.800,.774,6,7,.857,20,32,52,5,9,12,11,10,54
451,Zion Williamson\willizi01,PF,20,NOP,9,9,286,78,140,.557,0,2,.000,78,138,.565,.557,41,66,.621,33,40,73,12,12,4,25,20,197
452,D.J. Wilson\wilsodj01,PF,24,MIL,7,0,71,11,26,.423,7,16,.438,4,10,.400,.558,1,2,.500,3,16,19,3,1,2,4,9,30
453,Dylan Windler\windldy01,SF,24,CLE,1,0,9,1,5,.200,1,4,.250,0,1,.000,.300,0,0,,0,0,0,0,2,0,1,0,3
454,Cassius Winston\winstca01,PG,22,WAS,1,0,2,0,1,.000,0,1,.000,0,0,,.000,0,0,,0,0,0,1,0,0,0,1,0
455,James Wiseman\wisemja01,C,19,GSW,11,11,228,48,103,.466,6,15,.400,42,88,.477,.495,15,27,.556,15,55,70,3,4,17,17,36,117
456,Christian Wood\woodch01,C,25,HOU,8,8,263,74,140,.529,10,37,.270,64,103,.621,.564,23,32,.719,16,60,76,10,6,13,12,20,181
457,Robert Woodard\woodaro01,SF,21,SAC,4,0,14,5,10,.500,1,3,.333,4,7,.571,.550,0,2,.000,3,5,8,0,0,0,1,0,11
458,Delon Wright\wrighde01,SG,28,DET,11,6,289,28,74,.378,7,22,.318,21,52,.404,.426,20,23,.870,10,30,40,41,8,7,11,8,83
459,Thaddeus Young\youngth01,PF,32,CHI,7,0,177,33,55,.600,3,10,.300,30,45,.667,.627,6,7,.857,9,21,30,20,5,2,17,19,75
460,Trae Young\youngtr01,PG,22,ATL,10,10,330,72,173,.416,17,57,.298,55,116,.474,.465,87,99,.879,13,26,39,85,5,1,43,20,248
461,Cody Zeller\zelleco01,C,28,CHO,1,1,19,3,6,.500,0,2,.000,3,4,.750,.500,0,1,.000,1,2,3,0,3,1,1,1,6
462,Ivica Zubac\zubaciv01,C,23,LAC,12,0,216,32,47,.681,0,0,,32,47,.681,.681,26,33,.788,20,32,52,11,5,10,12,28,90

