Rk,Player,Pos,Age,Tm,G,GS,MP,FG,FGA,FG%,3P,3PA,3P%,2P,2PA,2P%,eFG%,FT,FTA,FT%,ORB,DRB,TRB,AST,STL,BLK,TOV,PF,PTS
1,Precious Achiuwa\achiupr01,PF,21,MIA,10,2,184,34,55,.618,0,0,,34,55,.618,.618,17,32,.531,23,36,59,11,2,4,16,26,85
2,Jaylen Adams\adamsja01,PG,24,MIL,1,0,1,0,1,.000,0,1,.000,0,0,,.000,0,0,,0,0,0,0,0,0,0,0,0
3,Steven Adams\adamsst01,C,27,NOP,11,11,342,48,71,.676,0,0,,48,71,.676,.676,13,29,.448,36,57,93,29,14,9,20,21,109
4,Bam Adebayo\adebaba01,C,23,MIA,8,8,243,52,81,.642,0,0,,52,81,.642,.642,35,44,.795,9,63,72,40,8,8,27,21,139
5,LaMarcus Aldridge\aldrila01,C,35,SAS,9,9,266,56,130,.431,11,40,.275,45,90,.500,.473,9,11,.818,9,39,48,23,5,7,12,21,132
6,Ty-Shon Alexander\alexaty01,SG,22,PHO,3,0,8,0,3,.000,0,1,.000,0,2,.000,.000,0,0,,0,1,1,1,0,0,0,1,0
7,Nickeil Alexander-Walker\alexani01,SG,22,NOP,9,2,157,41,85,.482,14,36,.389,27,49,.551,.565,8,8,1.000,2,21,23,13,7,1,15,20,104
8,Grayson Allen\allengr01,SG,25,MEM,10,4,206,20,55,.364,13,40,.325,7,15,.467,.482,15,16,.938,6,16,22,17,11,3,9,8,68
9,Jarrett Allen\allenja01,C,22,BRK,12,5,320,44,65,.677,0,0,,44,65,.677,.677,46,61,.754,38,87,125,20,7,19,22,21,134
10,Kyle Anderson\anderky01,PF,27,MEM,11,11,328,51,126,.405,16,48,.333,35,78,.449,.468,24,30,.800,10,70,80,46,4,7,21,20,142
11,Giannis Antetokounmpo\antetgi01,PF,26,MIL,12,12,373,116,217,.535,18,59,.305,98,158,.620,.576,69,120,.575,21,99,120,62,14,14,44,41,319
12,Kostas Antetokounmpo\antetko01,PF,23,LAL,1,0,8,0,2,.000,0,0,,0,2,.000,.000,0,0,,0,4,4,0,0,2,2,1,0
13,Thanasis Antetokounmpo\antetth01,SF,28,MIL,12,0,123,14,22,.636,2,7,.286,12,15,.800,.682,2,3,.667,12,12,24,12,3,1,13,21,32
14,Carmelo Anthony\anthoca01,PF,36,POR,11,0,269,41,102,.402,20,46,.435,21,56,.375,.500,31,35,.886,3,33,36,13,10,5,10,24,133
15,Cole Anthony\anthoco01,PG,20,ORL,12,4,283,42,129,.326,7,39,.179,35,90,.389,.353,28,32,.875,12,40,52,37,6,2,22,21,119
16,OG Anunoby\anunoog01,SF,23,TOR,11,11,382,47,104,.452,20,61,.328,27,43,.628,.548,25,35,.714,15,44,59,19,21,7,18,33,139
17,Ryan Arcidiacono\arcidry01,PG,26,CHI,2,0,28,3,9,.333,1,5,.200,2,4,.500,.389,3,3,1.000,0,6,6,4,2,0,0,2,10
18,D.J. Augustin\augusdj01,PG,33,MIL,12,0,222,22,60,.367,15,39,.385,7,21,.333,.492,14,14,1.000,7,9,16,34,5,0,13,6,73
19,Deni Avdija\avdijde01,SF,20,WAS,11,11,255,28,62,.452,16,35,.457,12,27,.444,.581,5,8,.625,4,40,44,24,11,3,7,29,77
20,Deandre Ayton\aytonde01,C,22,PHO,11,11,332,60,106,.566,1,4,.250,59,102,.578,.571,16,25,.640,32,92,124,20,4,11,20,37,137
21,Udoka Azubuike\azubuud01,C,21,UTA,6,0,30,3,5,.600,0,0,,3,5,.600,.600,2,4,.500,2,4,6,0,1,1,2,4,8
22,Dwayne Bacon\bacondw01,SG,25,ORL,12,12,303,48,111,.432,7,24,.292,41,87,.471,.464,14,20,.700,6,35,41,11,4,2,9,19,117
23,Marvin Bagley III\baglema01,PF,21,SAC,13,13,330,64,142,.451,12,33,.364,52,109,.477,.493,26,45,.578,27,72,99,13,4,8,23,33,166
24,LaMelo Ball\ballla01,PG,19,CHO,13,0,330,58,143,.406,20,60,.333,38,83,.458,.476,18,26,.692,23,67,90,82,21,5,29,34,154
25,Lonzo Ball\balllo01,PG,23,NOP,9,9,301,43,109,.394,20,65,.308,23,44,.523,.486,6,10,.600,4,35,39,40,10,6,26,26,112
26,Mo Bamba\bambamo01,C,22,ORL,4,0,33,8,18,.444,2,7,.286,6,11,.545,.500,2,3,.667,5,9,14,2,0,2,2,10,20
27,Desmond Bane\banede01,SG,22,MEM,11,0,245,33,73,.452,19,41,.463,14,32,.438,.582,7,9,.778,5,28,33,11,8,0,12,22,92
28,Harrison Barnes\barneha02,PF,28,SAC,13,13,450,76,151,.503,18,44,.409,58,107,.542,.563,52,64,.813,13,75,88,41,10,3,20,11,222
29,RJ Barrett\barrerj01,SG,20,NYK,13,13,488,80,208,.385,12,58,.207,68,150,.453,.413,44,61,.721,18,75,93,44,10,4,22,28,216
30,Will Barton\bartowi01,SF,30,DEN,12,8,350,55,131,.420,19,50,.380,36,81,.444,.492,16,24,.667,8,43,51,34,14,8,11,21,145
31,Keita Bates-Diop\bateske01,SF,25,SAS,2,0,2,0,1,.000,0,0,,0,1,.000,.000,0,0,,0,0,0,0,0,0,0,0,0
32,Nicolas Batum\batumni01,SF,32,LAC,13,13,370,43,87,.494,24,56,.429,19,31,.613,.632,18,21,.857,16,54,70,38,17,3,8,32,128
33,Aron Baynes\baynear01,C,34,TOR,8,8,143,18,47,.383,3,17,.176,15,30,.500,.415,0,0,,12,29,41,4,1,0,6,19,39
34,Kent Bazemore\bazemke01,SF,31,GSW,10,0,158,19,38,.500,8,16,.500,11,22,.500,.605,4,7,.571,3,24,27,20,8,5,12,18,50
35,Darius Bazley\bazleda01,PF,20,OKC,12,12,355,47,126,.373,15,56,.268,32,70,.457,.433,16,19,.842,9,82,91,18,7,12,23,16,125
36,Bradley Beal\bealbr01,SG,27,WAS,10,10,359,121,245,.494,24,64,.375,97,181,.536,.543,83,95,.874,15,38,53,50,14,7,33,25,349
37,Malik Beasley\beaslma01,SG,24,MIN,11,11,357,82,179,.458,29,75,.387,53,104,.510,.539,29,33,.879,8,44,52,22,6,3,13,14,222
38,DeAndre' Bembry\bembrde01,SF,26,TOR,5,0,18,2,4,.500,0,0,,2,4,.500,.500,0,0,,0,3,3,2,1,1,4,2,4
39,Dāvis Bertāns\bertada01,PF,28,WAS,11,0,264,38,102,.373,31,86,.360,7,16,.438,.525,23,28,.821,6,28,34,15,6,3,6,23,130
40,Patrick Beverley\beverpa01,PG,32,LAC,12,12,317,35,83,.422,24,55,.436,11,28,.393,.566,10,13,.769,17,34,51,23,10,10,11,45,104
41,Saddiq Bey\beysa01,SF,21,DET,10,3,230,32,86,.372,25,58,.431,7,28,.250,.517,16,21,.762,5,39,44,8,5,0,7,17,105
42,Tyler Bey\beyty01,SF,22,DAL,1,0,1,0,1,.000,0,0,,0,1,.000,.000,0,0,,0,0,0,0,0,0,0,0,0
43,Khem Birch\birchkh01,C,28,ORL,12,0,250,36,64,.563,1,2,.500,35,62,.565,.570,20,22,.909,34,41,75,12,11,4,7,24,93
44,Bismack Biyombo\biyombi01,C,28,CHO,13,12,343,42,74,.568,0,1,.000,42,73,.575,.568,16,34,.471,34,57,91,24,1,19,15,33,100
45,Nemanja Bjelica\bjeline01,PF,32,SAC,10,0,151,21,51,.412,5,21,.238,16,30,.533,.461,19,23,.826,10,26,36,19,0,2,12,20,66
46,Eric Bledsoe\bledser01,SG,31,NOP,10,9,290,41,94,.436,18,48,.375,23,46,.500,.532,13,18,.722,5,25,30,41,10,4,21,18,113
47,Keljin Blevins\blevike01,SF,25,POR,4,0,20,1,6,.167,0,3,.000,1,3,.333,.167,0,0,,0,0,0,4,1,0,3,3,2
48,Bogdan Bogdanović\bogdabo01,SG,28,ATL,9,2,213,30,78,.385,21,58,.362,9,20,.450,.519,8,9,.889,2,32,34,19,4,1,11,18,89
49,Bojan Bogdanović\bogdabo02,SF,31,UTA,12,12,361,55,143,.385,28,76,.368,27,67,.403,.483,20,24,.833,8,35,43,19,3,1,17,18,158
50,Bol Bol\bolbo01,PF,21,DEN,7,2,46,5,12,.417,2,6,.333,3,6,.500,.500,0,0,,0,5,5,1,0,3,5,7,12
51,Marques Bolden\boldema01,C,22,CLE,6,0,29,1,3,.333,0,0,,1,3,.333,.333,5,8,.625,3,3,6,0,2,2,2,0,7
52,Jordan Bone\bonejo01,PG,23,ORL,7,0,119,16,33,.485,5,16,.313,11,17,.647,.561,0,0,,3,13,16,10,1,0,1,4,37
53,Isaac Bonga\bongais01,SF,21,WAS,8,4,94,9,14,.643,6,10,.600,3,4,.750,.857,0,1,.000,3,15,18,6,2,3,3,13,24
54,Devin Booker\bookede01,SG,24,PHO,11,11,390,89,183,.486,23,66,.348,66,117,.564,.549,52,64,.813,3,33,36,47,12,4,44,33,253
55,Chris Boucher\bouchch01,C,28,TOR,11,0,251,60,102,.588,19,40,.475,41,62,.661,.681,29,38,.763,23,49,72,11,7,28,7,30,168
56,Avery Bradley\bradlav01,SG,30,MIA,7,1,160,25,51,.490,13,29,.448,12,22,.545,.618,7,9,.778,1,12,13,12,6,1,5,18,70
57,Tony Bradley\bradlto01,C,23,PHI,4,0,58,10,20,.500,0,1,.000,10,19,.526,.500,1,3,.333,13,18,31,3,2,5,1,4,21
58,Jarrell Brantley\brantja01,PF,24,UTA,1,0,6,0,1,.000,0,1,.000,0,0,,.000,0,0,,1,0,1,0,0,1,0,2,0
59,Ignas Brazdeikis\brazdig01,SF,22,NYK,3,0,4,0,1,.000,0,0,,0,1,.000,.000,2,2,1.000,1,1,2,0,0,0,0,0,2
60,Mikal Bridges\bridgmi01,SF,24,PHO,11,11,360,57,113,.504,29,64,.453,28,49,.571,.633,23,26,.885,14,45,59,14,6,13,3,21,166
61,Miles Bridges\bridgmi02,PF,22,CHO,13,0,338,46,100,.460,19,46,.413,27,54,.500,.555,9,9,1.000,14,56,70,24,10,13,24,30,120
62,Malcolm Brogdon\brogdma01,PG,28,IND,12,12,443,103,214,.481,37,81,.457,66,133,.496,.568,30,34,.882,9,41,50,89,22,2,20,21,273
63,Dillon Brooks\brookdi01,SF,25,MEM,11,11,331,70,181,.387,24,75,.320,46,106,.434,.453,19,23,.826,16,30,46,36,16,5,30,39,183
64,Bruce Brown\brownbr01,PG,24,BRK,9,5,137,22,40,.550,1,9,.111,21,31,.677,.563,3,5,.600,8,29,37,11,1,4,13,11,48
65,Jaylen Brown\brownja02,SG,24,BOS,11,11,371,109,203,.537,26,62,.419,83,141,.589,.601,40,50,.800,12,52,64,43,18,7,31,31,284
66,Moses Brown\brownmo01,C,21,OKC,4,0,16,3,5,.600,0,0,,3,5,.600,.600,5,12,.417,2,6,8,1,1,2,0,2,11
67,Sterling Brown\brownst02,SG,25,HOU,10,1,205,32,62,.516,17,37,.459,15,25,.600,.653,4,4,1.000,8,24,32,10,10,0,4,18,85
68,Troy Brown Jr.\browntr01,SF,21,WAS,7,0,123,13,30,.433,6,18,.333,7,12,.583,.533,0,3,.000,5,17,22,8,2,1,5,14,32
69,Jalen Brunson\brunsja01,PG,24,DAL,8,1,153,32,65,.492,7,22,.318,25,43,.581,.546,18,20,.900,0,20,20,28,4,0,14,9,89
70,Thomas Bryant\bryanth01,C,23,WAS,10,10,271,59,91,.648,9,21,.429,50,70,.714,.698,16,24,.667,18,43,61,15,4,8,11,31,143
71,Reggie Bullock\bullore01,SF,29,NYK,11,11,318,35,91,.385,15,47,.319,20,44,.455,.467,4,7,.571,4,43,47,15,8,2,10,30,89
72,Trey Burke\burketr01,PG,28,DAL,10,0,206,35,84,.417,20,45,.444,15,39,.385,.536,10,12,.833,3,12,15,19,5,2,8,18,100
73,Alec Burks\burksal01,SG,29,NYK,3,0,83,17,32,.531,10,15,.667,7,17,.412,.688,18,20,.900,0,11,11,11,3,2,7,10,62
74,Jimmy Butler\butleji01,SF,31,MIA,6,6,174,34,77,.442,0,7,.000,34,70,.486,.442,27,29,.931,10,23,33,32,13,4,11,4,95
75,Bruno Caboclo\cabocbr01,PF,25,HOU,6,0,36,8,17,.471,0,5,.000,8,12,.667,.471,1,2,.500,3,11,14,1,0,2,4,6,17
76,Kentavious Caldwell-Pope\caldwke01,SG,27,LAL,10,10,230,38,71,.535,21,38,.553,17,33,.515,.683,10,11,.909,5,15,20,14,12,3,8,15,107
77,Facundo Campazzo\campafa01,PG,29,DEN,11,0,135,15,37,.405,11,28,.393,4,9,.444,.554,10,13,.769,0,10,10,15,7,1,9,21,51
78,Vlatko Čančar\cancavl01,PF,23,DEN,4,0,10,0,2,.000,0,1,.000,0,1,.000,.000,0,0,,1,0,1,0,1,1,2,0,0
79,Clint Capela\capelca01,C,26,ATL,9,9,238,42,76,.553,0,0,,42,76,.553,.553,12,25,.480,32,82,114,10,5,8,10,17,96
80,Vernon Carey Jr.\careyve01,C,19,CHO,3,0,6,1,3,.333,0,1,.000,1,2,.500,.333,1,2,.500,2,1,3,1,0,1,0,0,3
81,Jevon Carter\carteje01,PG,25,PHO,11,0,145,16,43,.372,6,27,.222,10,16,.625,.442,0,0,,1,16,17,10,7,5,2,18,38
82,Wendell Carter Jr.\cartewe01,C,21,CHI,12,12,330,58,108,.537,3,14,.214,55,94,.585,.551,38,52,.731,28,69,97,32,3,8,22,40,157
83,Michael Carter-Williams\cartemi01,SG,29,ORL,7,2,160,15,44,.341,1,12,.083,14,32,.438,.352,5,6,.833,15,21,36,12,4,4,9,19,36
84,Alex Caruso\carusal01,PG,26,LAL,9,0,157,18,36,.500,14,24,.583,4,12,.333,.694,1,2,.500,3,21,24,20,10,2,11,9,51
85,Willie Cauley-Stein\caulewi01,C,27,DAL,11,5,204,25,39,.641,0,1,.000,25,38,.658,.641,15,23,.652,19,49,68,11,4,8,7,31,65
86,Chris Chiozza\chiozch01,PG,25,BRK,6,0,83,9,36,.250,4,15,.267,5,21,.238,.306,4,6,.667,3,5,8,18,4,3,6,5,26
87,Marquese Chriss\chrisma01,PF,23,GSW,2,0,27,5,14,.357,1,5,.200,4,9,.444,.393,2,4,.500,3,10,13,2,0,2,2,3,13
88,Gary Clark\clarkga01,SF,26,ORL,9,2,185,8,31,.258,5,24,.208,3,7,.429,.339,2,3,.667,10,24,34,5,4,2,9,12,23
89,Brandon Clarke\clarkbr01,PF,24,MEM,11,7,316,64,134,.478,6,24,.250,58,110,.527,.500,10,23,.435,18,45,63,19,10,9,9,18,144
90,Jordan Clarkson\clarkjo01,SG,28,UTA,12,0,296,78,161,.484,35,83,.422,43,78,.551,.593,14,15,.933,14,43,57,22,11,3,25,17,205
91,Amir Coffey\coffeam01,SG,23,LAC,9,0,46,6,15,.400,3,7,.429,3,8,.375,.500,2,3,.667,2,1,3,4,0,0,0,3,17
92,John Collins\collijo01,PF,23,ATL,11,11,307,68,126,.540,13,36,.361,55,90,.611,.591,31,39,.795,26,55,81,17,8,7,13,36,180
93,Mike Conley\conlemi01,PG,33,UTA,12,12,361,71,156,.455,36,83,.434,35,73,.479,.571,27,35,.771,13,38,51,70,16,1,27,24,205
94,Pat Connaughton\connapa01,SG,28,MIL,10,0,169,21,47,.447,16,33,.485,5,14,.357,.617,2,2,1.000,10,28,38,14,8,4,1,12,60
95,Quinn Cook\cookqu01,PG,27,LAL,10,0,37,7,15,.467,4,8,.500,3,7,.429,.600,4,5,.800,0,2,2,3,1,0,1,1,22
96,DeMarcus Cousins\couside01,C,30,HOU,8,1,112,18,53,.340,8,25,.320,10,28,.357,.415,13,18,.722,9,38,47,13,6,8,10,15,57
97,Robert Covington\covinro01,PF,30,POR,12,12,366,27,81,.333,20,61,.328,7,20,.350,.457,7,8,.875,6,61,67,20,17,6,15,33,81
98,Torrey Craig\craigto01,SF,30,MIL,2,0,13,0,1,.000,0,0,,0,1,.000,.000,0,0,,0,4,4,2,0,1,1,2,0
99,Jae Crowder\crowdja01,PF,30,PHO,11,11,317,36,89,.404,25,71,.352,11,18,.611,.545,12,14,.857,4,50,54,25,7,1,7,26,109
100,Jarrett Culver\culveja01,SG,21,MIN,11,7,247,33,75,.440,5,22,.227,28,53,.528,.473,10,19,.526,21,41,62,12,6,3,16,25,81
101,Seth Curry\curryse01,SG,30,PHI,8,8,240,47,78,.603,25,42,.595,22,36,.611,.763,17,17,1.000,1,17,18,29,6,3,12,14,136
102,Stephen Curry\curryst01,PG,32,GSW,12,12,414,110,246,.447,50,133,.376,60,113,.531,.549,71,76,.934,9,58,67,74,15,2,41,27,341
103,Anthony Davis\davisan02,PF,27,LAL,12,12,383,102,187,.545,13,35,.371,89,152,.586,.580,43,57,.754,21,79,100,37,15,22,21,17,260
104,Ed Davis\davised01,C,31,MIN,8,4,111,8,21,.381,0,0,,8,21,.381,.381,3,4,.750,19,25,44,6,3,4,2,18,19
105,Terence Davis\daviste02,SG,23,TOR,7,0,85,18,39,.462,9,22,.409,9,17,.529,.577,5,5,1.000,1,10,11,8,3,1,6,9,50
106,DeMar DeRozan\derozde01,SF,31,SAS,10,10,345,70,147,.476,9,25,.360,61,122,.500,.507,55,63,.873,7,49,56,70,9,7,13,21,204
107,Hamidou Diallo\diallha01,SG,22,OKC,12,0,245,53,98,.541,4,13,.308,49,85,.576,.561,26,39,.667,10,49,59,22,12,4,15,27,136
108,Gorgui Dieng\dienggo01,C,31,MEM,9,0,153,28,54,.519,10,24,.417,18,30,.600,.611,7,7,1.000,11,30,41,14,9,5,10,14,73
109,Spencer Dinwiddie\dinwisp01,SG,27,BRK,3,3,64,6,16,.375,2,7,.286,4,9,.444,.438,6,6,1.000,0,13,13,9,2,1,5,4,20
110,Donte DiVincenzo\divindo01,SG,24,MIL,13,13,326,50,111,.450,28,63,.444,22,48,.458,.577,6,8,.750,10,43,53,33,19,3,16,16,134
111,Luka Dončić\doncilu01,PG,21,DAL,10,10,342,99,211,.469,19,73,.260,80,138,.580,.514,58,78,.744,8,87,95,88,11,9,43,18,275
112,Luguentz Dort\dortlu01,SG,21,OKC,12,12,343,52,113,.460,28,65,.431,24,48,.500,.584,22,28,.786,9,37,46,9,14,4,14,30,154
113,Damyean Dotson\dotsoda01,SG,26,CLE,12,6,318,42,103,.408,14,54,.259,28,49,.571,.476,10,15,.667,2,18,20,36,8,2,13,13,108
114,Devon Dotson\dotsode01,PG,21,CHI,1,0,10,2,4,.500,0,0,,2,4,.500,.500,0,0,,0,1,1,0,0,0,0,1,4
115,Sekou Doumbouya\doumbse01,PF,20,DET,10,0,114,14,42,.333,7,16,.438,7,26,.269,.417,8,9,.889,6,18,24,5,4,2,2,11,43
116,PJ Dozier\doziepj01,SG,24,DEN,12,0,242,31,71,.437,9,24,.375,22,47,.468,.500,10,15,.667,13,42,55,15,3,8,11,22,81
117,Goran Dragić\dragigo01,PG,34,MIA,8,0,188,42,83,.506,14,37,.378,28,46,.609,.590,20,23,.870,4,14,18,40,5,0,22,19,118
118,Andre Drummond\drumman01,C,27,CLE,12,12,387,94,198,.475,0,7,.000,94,191,.492,.475,43,77,.558,53,136,189,35,20,19,45,38,231
119,Jared Dudley\dudleja01,PF,35,LAL,6,0,22,1,1,1.000,1,1,1.000,0,0,,1.500,0,0,,1,5,6,1,0,0,0,0,3
120,Kevin Durant\duranke01,PF,32,BRK,9,9,309,87,162,.537,24,52,.462,63,110,.573,.611,67,78,.859,4,61,65,52,7,8,33,18,265
121,Anthony Edwards\edwaran01,SG,19,MIN,11,0,272,53,140,.379,16,60,.267,37,80,.463,.436,16,21,.762,12,20,32,21,6,2,20,19,138
122,Carsen Edwards\edwarca01,SG,22,BOS,4,0,29,6,15,.400,1,5,.200,5,10,.500,.433,0,0,,1,2,3,2,0,1,1,3,13
123,CJ Elleby\ellebcj01,SF,20,POR,6,0,34,5,8,.625,2,5,.400,3,3,1.000,.750,2,3,.667,1,1,2,2,0,1,1,7,14
124,Wayne Ellington\ellinwa01,SG,33,DET,6,3,97,18,39,.462,10,27,.370,8,12,.667,.590,1,1,1.000,3,8,11,3,2,3,2,8,47
125,Joel Embiid\embiijo01,C,26,PHI,11,11,344,90,168,.536,13,33,.394,77,135,.570,.574,82,97,.845,18,108,126,32,15,16,35,23,275
126,James Ennis\ennisja01,SF,30,ORL,5,4,87,8,22,.364,1,7,.143,7,15,.467,.386,4,4,1.000,3,7,10,5,5,0,5,8,21
127,Drew Eubanks\eubandr01,PF,23,SAS,3,0,58,3,13,.231,0,0,,3,13,.231,.231,3,4,.750,1,12,13,1,1,6,1,7,9
128,Dante Exum\exumda01,SG,25,CLE,6,3,116,10,26,.385,2,11,.182,8,15,.533,.423,1,2,.500,2,15,17,13,4,2,7,9,23
129,Tacko Fall\fallta01,C,25,BOS,3,0,33,5,7,.714,0,0,,5,7,.714,.714,2,4,.500,3,10,13,0,0,6,0,5,12
130,Derrick Favors\favorde01,C,29,UTA,12,0,195,31,53,.585,0,0,,31,53,.585,.585,9,14,.643,23,49,72,13,3,14,7,31,71
131,Cristiano Felício\feliccr01,C,28,CHI,1,0,6,0,1,.000,0,0,,0,1,.000,.000,0,2,.000,2,1,3,2,0,0,0,0,0
132,Terrance Ferguson\fergute01,SG,22,PHI,5,0,18,0,3,.000,0,3,.000,0,0,,.000,0,0,,0,1,1,1,0,0,1,2,0
133,Bruno Fernando\fernabr01,C,22,ATL,8,0,89,6,14,.429,0,2,.000,6,12,.500,.429,2,5,.400,9,28,37,6,2,1,10,9,14
134,Yogi Ferrell\ferreyo01,G,27,CLE,2,0,40,8,21,.381,3,9,.333,5,12,.417,.452,0,2,.000,3,4,7,5,3,1,3,4,19
135,Dorian Finney-Smith\finnedo01,PF,27,DAL,8,8,235,27,65,.415,14,43,.326,13,22,.591,.523,6,7,.857,11,29,40,8,11,5,4,24,74
136,Malachi Flynn\flynnma01,PG,22,TOR,7,0,59,6,22,.273,3,13,.231,3,9,.333,.341,0,0,,0,6,6,7,2,0,1,6,15
137,Bryn Forbes\forbebr01,SG,27,MIL,13,0,222,37,82,.451,21,49,.429,16,33,.485,.579,6,10,.600,2,12,14,5,4,0,11,16,101
138,Trent Forrest\forretr01,PG,22,UTA,2,0,9,0,0,,0,0,,0,0,,,2,2,1.000,0,0,0,1,1,0,0,2,2
139,Evan Fournier\fournev01,SF,28,ORL,5,5,127,23,45,.511,8,23,.348,15,22,.682,.600,20,23,.870,2,6,8,10,7,0,9,13,74
140,De'Aaron Fox\foxde01,PG,23,SAC,13,13,391,86,190,.453,17,49,.347,69,141,.489,.497,55,78,.705,8,29,37,68,17,9,40,29,244
141,Tim Frazier\fraziti01,PG,30,MEM,3,0,33,2,8,.250,0,2,.000,2,6,.333,.250,0,0,,0,4,4,7,1,0,3,4,4
142,Markelle Fultz\fultzma01,PG,22,ORL,8,8,215,41,104,.394,4,16,.250,37,88,.420,.413,17,19,.895,5,20,25,43,8,2,18,18,103
143,Daniel Gafford\gaffoda01,PF,22,CHI,10,0,139,19,27,.704,0,0,,19,27,.704,.704,13,20,.650,10,12,22,6,7,11,6,19,51
144,Danilo Gallinari\gallida01,PF,32,ATL,2,1,28,6,8,.750,2,3,.667,4,5,.800,.875,4,4,1.000,0,5,5,3,0,0,3,2,18
145,Langston Galloway\gallola01,SG,29,PHO,11,0,105,17,37,.459,13,27,.481,4,10,.400,.635,7,7,1.000,3,7,10,4,0,0,2,4,54
146,Darius Garland\garlada01,PG,21,CLE,6,6,215,40,88,.455,15,32,.469,25,56,.446,.540,8,9,.889,3,17,20,38,8,2,18,19,103
147,Marc Gasol\gasolma01,C,36,LAL,14,14,276,20,43,.465,8,21,.381,12,22,.545,.558,14,16,.875,15,55,70,29,7,22,18,40,62
148,Rudy Gay\gayru01,PF,34,SAS,12,0,271,53,125,.424,19,58,.328,34,67,.507,.500,9,12,.750,11,51,62,17,8,10,11,25,134
149,Paul George\georgpa01,SF,30,LAC,12,12,415,98,195,.503,51,99,.515,47,96,.490,.633,56,61,.918,8,65,73,62,15,6,45,26,303
150,Harry Giles\gilesha01,C,22,POR,8,0,63,7,17,.412,2,4,.500,5,13,.385,.471,4,6,.667,3,22,25,4,4,5,5,15,20
151,Shai Gilgeous-Alexander\gilgesh01,SG,22,OKC,12,12,407,92,181,.508,22,59,.373,70,122,.574,.569,53,68,.779,10,54,64,74,11,5,31,30,259
152,Anthony Gill\gillan01,PF,28,WAS,4,0,14,2,3,.667,1,2,.500,1,1,1.000,.833,2,2,1.000,0,3,3,0,1,0,0,2,7
153,Rudy Gobert\goberru01,C,28,UTA,12,12,362,58,101,.574,0,0,,58,101,.574,.574,27,56,.482,40,120,160,17,6,33,21,24,143
154,Brandon Goodwin\goodwbr01,PG,25,ATL,9,0,134,17,51,.333,8,29,.276,9,22,.409,.412,8,12,.667,1,12,13,21,4,0,4,7,50
155,Aaron Gordon\gordoaa01,PF,25,ORL,11,11,301,60,126,.476,18,47,.383,42,79,.532,.548,27,46,.587,15,53,68,31,9,7,22,17,165
156,Eric Gordon\gordoer01,SG,32,HOU,7,1,179,33,76,.434,16,54,.296,17,22,.773,.539,18,20,.900,2,13,15,11,7,6,11,13,100
157,Devonte' Graham\grahade01,PG,25,CHO,13,13,431,49,163,.301,32,102,.314,17,61,.279,.399,25,31,.806,8,34,42,83,21,0,17,20,155
158,Jerami Grant\grantje01,SF,26,DET,11,11,404,93,204,.456,30,78,.385,63,126,.500,.529,57,66,.864,12,54,66,20,11,13,17,30,273
159,Danny Green\greenda02,SF,33,PHI,13,13,362,43,116,.371,33,88,.375,10,28,.357,.513,7,10,.700,17,31,48,36,17,8,23,26,126
160,Draymond Green\greendr01,PF,30,GSW,8,8,215,9,32,.281,3,15,.200,6,17,.353,.328,11,17,.647,3,37,40,53,11,2,19,26,32
161,JaMychal Green\greenja01,PF,30,DEN,8,0,172,33,64,.516,19,36,.528,14,28,.500,.664,10,14,.714,14,40,54,9,4,0,16,18,95
162,Javonte Green\greenja02,SG,27,BOS,4,0,64,10,17,.588,1,6,.167,9,11,.818,.618,5,8,.625,5,5,10,3,5,0,3,3,26
163,Jeff Green\greenje02,PF,34,BRK,13,6,271,30,54,.556,14,31,.452,16,23,.696,.685,5,7,.714,6,29,35,14,7,2,9,21,79
164,Josh Green\greenjo02,SG,20,DAL,9,1,85,4,11,.364,0,3,.000,4,8,.500,.364,3,6,.500,6,11,17,3,2,0,5,9,11
165,Blake Griffin\griffbl01,PF,31,DET,8,8,257,36,94,.383,18,57,.316,18,37,.486,.479,19,28,.679,3,44,47,34,8,0,13,11,109
166,Kyle Guy\guyky01,PG,23,SAC,4,0,34,4,14,.286,2,5,.400,2,9,.222,.357,5,6,.833,0,5,5,7,1,0,0,0,15
167,Rui Hachimura\hachiru01,PF,22,WAS,7,7,194,35,70,.500,4,13,.308,31,57,.544,.529,21,28,.750,6,26,32,16,4,1,5,17,95
168,Tyrese Haliburton\halibty01,PG,20,SAC,11,1,313,48,92,.522,26,50,.520,22,42,.524,.663,9,11,.818,8,23,31,62,14,4,13,14,131
169,Josh Hall\halljo01,SF,20,OKC,4,0,26,1,11,.091,1,6,.167,0,5,.000,.136,0,2,.000,1,3,4,4,0,0,1,5,3
170,R.J. Hampton\hamptrj01,PG,19,DEN,8,0,16,3,5,.600,0,1,.000,3,4,.750,.600,0,0,,1,1,2,0,0,0,1,2,6
171,Tim Hardaway Jr.\hardati02,SG,28,DAL,11,9,344,73,157,.465,42,99,.424,31,58,.534,.599,18,28,.643,1,43,44,23,8,3,12,17,206
172,James Harden\hardeja01,SG,31,HOU,8,8,290,60,135,.444,25,72,.347,35,63,.556,.537,53,60,.883,5,36,41,83,7,6,34,14,198
173,Maurice Harkless\harklma01,SF,27,MIA,6,2,49,1,6,.167,1,4,.250,0,2,.000,.250,0,2,.000,0,5,5,1,0,0,2,7,3
174,Jared Harper\harpeja01,PG,23,NYK,2,0,5,0,1,.000,0,0,,0,1,.000,.000,2,2,1.000,0,0,0,0,0,0,2,0,2
175,Montrezl Harrell\harremo01,C,27,LAL,14,0,339,79,127,.622,0,4,.000,79,123,.642,.622,35,49,.714,41,62,103,13,8,7,16,27,193
176,Gary Harris\harriga01,SG,26,DEN,10,10,317,42,91,.462,11,41,.268,31,50,.620,.522,11,15,.733,6,17,23,14,10,3,8,20,106
177,Jalen Harris\harrija01,SG,22,TOR,1,0,2,0,0,,0,0,,0,0,,,0,0,,0,0,0,0,0,0,0,1,0
178,Joe Harris\harrijo01,SF,29,BRK,13,10,376,73,140,.521,38,76,.500,35,64,.547,.657,4,8,.500,11,36,47,28,9,4,13,31,188
179,Tobias Harris\harrito02,PF,28,PHI,10,10,325,75,147,.510,23,51,.451,52,96,.542,.588,16,19,.842,13,62,75,30,11,9,20,22,189
180,Shaquille Harrison\harrish01,SG,27,UTA,6,0,27,4,11,.364,0,0,,4,11,.364,.364,1,2,.500,2,3,5,4,2,0,3,2,9
181,Josh Hart\hartjo01,SF,25,NOP,11,2,321,30,72,.417,14,44,.318,16,28,.571,.514,15,23,.652,10,79,89,18,9,1,9,24,89
182,Isaiah Hartenstein\harteis01,C,22,DEN,10,0,95,18,33,.545,0,0,,18,33,.545,.545,10,19,.526,17,14,31,7,4,9,11,24,46
183,Jaxson Hayes\hayesja02,C,20,NOP,11,0,127,15,28,.536,0,0,,15,28,.536,.536,7,9,.778,16,30,46,7,2,6,7,19,37
184,Killian Hayes\hayeski01,PG,19,DET,7,7,148,13,47,.277,5,20,.250,8,27,.296,.330,1,2,.500,1,7,8,25,2,0,17,15,32
185,Gordon Hayward\haywago01,SF,30,CHO,12,12,410,97,198,.490,26,63,.413,71,135,.526,.556,44,48,.917,8,53,61,45,15,5,25,26,264
186,Juan Hernangómez\hernaju01,PF,25,MIN,11,6,224,27,68,.397,12,39,.308,15,29,.517,.485,7,10,.700,10,48,58,6,5,2,4,10,73
187,Willy Hernangómez\hernawi01,C,26,NOP,1,0,7,0,1,.000,0,0,,0,1,.000,.000,1,4,.250,0,4,4,1,0,0,0,0,1
188,Tyler Herro\herroty01,SG,21,MIA,10,10,337,67,143,.469,16,53,.302,51,90,.567,.524,26,34,.765,1,66,67,38,4,1,28,16,176
189,Buddy Hield\hieldbu01,SG,28,SAC,13,13,441,67,184,.364,49,136,.360,18,48,.375,.497,14,17,.824,3,50,53,40,9,4,22,40,197
190,George Hill\hillge01,PG,34,OKC,11,11,288,45,94,.479,15,45,.333,30,49,.612,.559,20,24,.833,7,17,24,38,10,2,9,12,125
191,Solomon Hill\hillso01,PF,29,ATL,11,0,200,19,53,.358,16,43,.372,3,10,.300,.509,3,3,1.000,7,28,35,8,6,4,6,21,57
192,Nate Hinton\hintona01,SG,21,DAL,2,0,2,0,1,.000,0,1,.000,0,0,,.000,0,0,,0,0,0,0,0,0,0,0,0
193,Aaron Holiday\holidaa01,PG,24,IND,12,6,256,30,82,.366,10,38,.263,20,44,.455,.427,5,6,.833,4,13,17,30,12,2,8,26,75
194,Jrue Holiday\holidjr01,PG,30,MIL,13,13,413,77,158,.487,22,58,.379,55,100,.550,.557,22,26,.846,12,43,55,65,28,9,19,27,198
195,Justin Holiday\holidju01,SG,31,IND,12,3,352,45,85,.529,22,49,.449,23,36,.639,.659,16,22,.727,8,35,43,14,13,4,12,32,128
196,Richaun Holmes\holmeri01,C,27,SAC,12,12,346,70,100,.700,1,3,.333,69,97,.711,.705,25,30,.833,33,58,91,24,11,16,15,51,166
197,Rodney Hood\hoodro01,SF,28,POR,10,0,131,6,30,.200,3,14,.214,3,16,.188,.250,0,0,,0,11,11,14,6,2,6,11,15
198,Al Horford\horfoal01,C,34,OKC,9,9,244,41,98,.418,16,50,.320,25,48,.521,.500,2,4,.500,5,59,64,22,3,7,8,14,100
199,Talen Horton-Tucker\hortota01,SG,20,LAL,13,0,203,33,78,.423,8,29,.276,25,49,.510,.474,15,18,.833,7,23,30,26,11,6,13,24,89
200,Danuel House\houseda01,SF,27,HOU,4,4,130,10,27,.370,3,15,.200,7,12,.583,.426,7,10,.700,1,17,18,9,1,1,1,10,30
201,Dwight Howard\howardw01,C,35,PHI,13,2,217,35,51,.686,3,6,.500,32,45,.711,.716,16,26,.615,25,66,91,9,3,8,24,43,89
202,Markus Howard\howarma02,SG,21,DEN,5,0,7,1,5,.200,0,4,.000,1,1,1.000,.200,0,0,,0,0,0,1,0,0,0,1,2
203,Kevin Huerter\huertke01,SG,22,ATL,11,0,294,49,115,.426,23,64,.359,26,51,.510,.526,7,9,.778,11,26,37,35,12,1,11,26,128
204,Elijah Hughes\hugheel01,SF,22,UTA,6,0,27,5,15,.333,3,10,.300,2,5,.400,.433,3,4,.750,0,4,4,3,1,1,4,0,16
205,De'Andre Hunter\huntede01,SF,23,ATL,11,11,344,63,123,.512,20,49,.408,43,74,.581,.593,31,36,.861,12,58,70,22,6,6,11,31,177
206,Chandler Hutchison\hutchch01,SF,24,CHI,4,0,52,5,16,.313,1,3,.333,4,13,.308,.344,2,2,1.000,1,16,17,4,1,0,3,7,13
207,Serge Ibaka\ibakase01,C,31,LAC,13,13,326,63,122,.516,13,38,.342,50,84,.595,.570,14,18,.778,20,61,81,24,3,15,17,30,153
208,Andre Iguodala\iguodan01,SF,37,MIA,9,2,172,14,39,.359,11,28,.393,3,11,.273,.500,0,0,,4,24,28,24,5,3,10,14,39
209,Joe Ingles\inglejo01,SF,33,UTA,9,0,233,33,70,.471,16,45,.356,17,25,.680,.586,7,9,.778,5,32,37,29,3,1,15,18,89
210,Brandon Ingram\ingrabr01,SF,23,NOP,11,11,385,89,194,.459,22,62,.355,67,132,.508,.515,58,68,.853,11,62,73,60,8,10,32,13,258
211,Kyrie Irving\irvinky01,PG,28,BRK,7,7,231,71,141,.504,26,61,.426,45,80,.563,.596,22,22,1.000,5,32,37,43,11,2,15,18,190
212,Wesley Iwundu\iwundwe01,SF,26,DAL,7,2,102,8,21,.381,2,9,.222,6,12,.500,.429,3,4,.750,2,15,17,3,3,0,2,5,21
213,Frank Jackson\jacksfr01,PG,22,DET,3,0,24,2,10,.200,2,8,.250,0,2,.000,.300,0,0,,0,4,4,5,1,0,3,3,6
214,Josh Jackson\jacksjo02,SG,23,DET,9,6,202,43,99,.434,12,40,.300,31,59,.525,.495,13,19,.684,5,27,32,16,10,4,14,24,111
215,Justin Jackson\jacksju01,SF,25,OKC,4,1,57,7,19,.368,1,12,.083,6,7,.857,.395,5,6,.833,1,8,9,3,1,0,5,3,20
216,Reggie Jackson\jacksre01,SG,30,LAC,11,1,153,26,56,.464,13,32,.406,13,24,.542,.580,2,5,.400,1,18,19,23,5,1,5,16,67
217,Justin James\jamesju01,SF,24,SAC,5,0,41,5,12,.417,0,4,.000,5,8,.625,.417,1,7,.143,1,5,6,3,1,1,0,0,11
218,LeBron James\jamesle01,PG,36,LAL,14,14,445,122,251,.486,34,89,.382,88,162,.543,.554,59,81,.728,11,102,113,108,11,5,49,19,337
219,Isaiah Joe\joeis01,SG,21,PHI,8,1,156,19,52,.365,15,41,.366,4,11,.364,.510,5,5,1.000,4,12,16,11,4,4,3,15,58
220,Cameron Johnson\johnsca02,PF,24,PHO,11,0,255,48,102,.471,28,73,.384,20,29,.690,.608,12,14,.857,3,32,35,16,6,6,6,11,136
221,James Johnson\johnsja01,PF,33,DAL,11,0,200,24,56,.429,8,26,.308,16,30,.533,.500,9,18,.500,5,28,33,23,17,8,10,22,65
222,Keldon Johnson\johnske04,SF,21,SAS,12,12,384,66,137,.482,15,38,.395,51,99,.515,.536,31,39,.795,21,66,87,28,15,9,19,35,178
223,Stanley Johnson\johnsst04,PF,24,TOR,9,0,127,9,23,.391,4,12,.333,5,11,.455,.478,1,2,.500,8,20,28,13,10,2,7,13,23
224,Tyler Johnson\johnsty01,SG,28,BRK,4,0,30,3,7,.429,3,5,.600,0,2,.000,.643,0,0,,1,1,2,7,3,0,0,1,9
225,Nikola Jokić\jokicni01,C,25,DEN,12,12,421,107,188,.569,14,38,.368,93,150,.620,.606,62,74,.838,29,105,134,125,23,6,49,39,290
226,Damian Jones\jonesda03,C,25,PHO,5,0,42,3,6,.500,0,1,.000,3,5,.600,.500,2,5,.400,4,5,9,0,1,3,3,9,8
227,Derrick Jones Jr.\jonesde02,SF,23,POR,12,12,317,29,66,.439,9,29,.310,20,37,.541,.508,14,24,.583,15,30,45,8,13,10,8,33,81
228,Mason Jones\jonesma05,SG,22,HOU,4,0,37,7,17,.412,1,6,.167,6,11,.545,.441,4,7,.571,2,6,8,4,1,0,4,3,19
229,Tre Jones\jonestr01,PG,21,SAS,3,0,10,4,7,.571,0,0,,4,7,.571,.571,3,3,1.000,3,0,3,1,0,0,0,0,11
230,Tyus Jones\jonesty01,PG,24,MEM,11,8,297,40,96,.417,7,31,.226,33,65,.508,.453,5,7,.714,4,27,31,63,17,3,12,5,92
231,DeAndre Jordan\jordade01,C,32,BRK,12,8,217,23,29,.793,0,0,,23,29,.793,.793,8,16,.500,17,66,83,21,2,15,21,28,54
232,Cory Joseph\josepco01,PG,29,SAC,13,0,278,32,78,.410,8,28,.286,24,50,.480,.462,16,21,.762,6,25,31,31,9,5,18,35,88
233,Mfiondu Kabengele\kabenmf01,PF,23,LAC,8,0,39,2,13,.154,1,8,.125,1,5,.200,.192,2,2,1.000,0,4,4,2,2,1,2,9,7
234,Frank Kaminsky\kaminfr01,C,27,PHO,5,0,40,7,18,.389,1,4,.250,6,14,.429,.417,2,4,.500,5,4,9,4,0,1,1,3,17
235,Enes Kanter\kanteen01,C,28,POR,12,0,224,50,78,.641,0,0,,50,78,.641,.641,20,25,.800,43,64,107,6,6,6,12,23,120
236,Luke Kennard\kennalu01,SG,24,LAC,13,3,302,41,82,.500,20,40,.500,21,42,.500,.622,8,9,.889,2,35,37,25,3,4,16,23,110
237,Maxi Kleber\klebima01,PF,29,DAL,9,3,219,18,41,.439,16,34,.471,2,7,.286,.634,15,16,.938,7,41,48,12,3,8,6,17,67
238,Nathan Knight\knighna01,PF,23,ATL,6,0,35,5,15,.333,3,7,.429,2,8,.250,.433,4,5,.800,6,4,10,1,0,3,3,5,17
239,Kevin Knox\knoxke01,SF,21,NYK,13,0,282,39,89,.438,22,50,.440,17,39,.436,.562,6,8,.750,7,30,37,12,5,6,14,22,106
240,John Konchar\konchjo01,SG,24,MEM,5,0,98,10,23,.435,3,8,.375,7,15,.467,.500,6,6,1.000,5,18,23,14,7,2,1,6,29
241,Furkan Korkmaz\korkmfu01,SG,23,PHI,3,0,55,6,24,.250,4,16,.250,2,8,.250,.333,2,2,1.000,0,6,6,3,2,2,6,2,18
242,Luke Kornet\kornelu01,PF,25,CHI,1,0,7,0,2,.000,0,2,.000,0,0,,.000,2,2,1.000,0,1,1,0,1,0,1,0,2
243,Rodions Kurucs\kurucro01,PF,22,BRK,5,0,16,1,3,.333,1,2,.500,0,1,.000,.500,0,0,,0,3,3,2,0,0,0,1,3
244,Kyle Kuzma\kuzmaky01,SF,25,LAL,14,4,347,57,132,.432,26,65,.400,31,67,.463,.530,8,12,.667,16,56,72,17,4,10,22,26,148
245,Zach LaVine\lavinza01,SG,25,CHI,12,12,430,118,237,.498,44,111,.396,74,126,.587,.591,60,71,.845,4,59,63,57,15,7,51,35,340
246,Jake Layman\laymaja01,SF,26,MIN,9,3,127,14,32,.438,2,12,.167,12,20,.600,.469,13,15,.867,0,7,7,6,7,4,4,14,43
247,Jalen Lecque\lecquja01,PG,20,IND,2,0,4,1,2,.500,0,0,,1,2,.500,.500,1,1,1.000,1,2,3,1,0,0,0,0,3
248,Damion Lee\leeda03,SG,28,GSW,12,0,229,28,60,.467,21,47,.447,7,13,.538,.642,8,10,.800,7,33,40,20,10,0,5,23,85
249,Saben Lee\leesa01,PG,21,DET,2,0,25,3,9,.333,0,1,.000,3,8,.375,.333,2,4,.500,1,0,1,1,3,0,3,2,8
250,Alex Len\lenal01,C,27,TOR,7,2,76,5,10,.500,3,6,.500,2,4,.500,.650,3,6,.500,0,11,11,3,1,6,8,10,16
251,Kawhi Leonard\leonaka01,SF,29,LAC,11,11,378,98,203,.483,22,51,.431,76,152,.500,.537,57,65,.877,11,43,54,66,21,8,21,21,275
252,Meyers Leonard\leoname01,C,28,MIA,3,2,29,3,7,.429,3,7,.429,0,0,,.643,1,2,.500,0,7,7,2,0,0,2,5,10
253,Caris LeVert\leverca01,SG,26,BRK,12,4,334,87,200,.435,22,63,.349,65,137,.474,.490,26,34,.765,10,42,52,72,13,6,26,20,222
254,Kira Lewis Jr.\lewiski01,PG,19,NOP,4,0,39,7,21,.333,2,8,.250,5,13,.385,.381,2,2,1.000,0,2,2,3,1,1,1,3,18
255,Damian Lillard\lillada01,PG,30,POR,12,12,428,99,224,.442,45,119,.378,54,105,.514,.542,80,86,.930,4,52,56,81,12,3,35,15,323
256,Nassir Little\littlna01,PF,20,POR,3,0,18,2,3,.667,1,1,1.000,1,2,.500,.833,0,0,,1,2,3,0,0,1,2,2,5
257,Kevon Looney\looneke01,C,24,GSW,12,0,167,18,29,.621,0,3,.000,18,26,.692,.621,8,11,.727,14,29,43,16,4,2,10,23,44
258,Brook Lopez\lopezbr01,C,32,MIL,13,13,346,43,105,.410,24,66,.364,19,39,.487,.524,11,13,.846,19,50,69,12,8,21,9,26,121
259,Robin Lopez\lopezro01,C,32,WAS,11,1,178,28,45,.622,2,5,.400,26,40,.650,.644,13,25,.520,20,26,46,6,1,6,7,23,71
260,Kevin Love\loveke01,PF,32,CLE,2,2,46,6,18,.333,3,9,.333,3,9,.333,.417,4,5,.800,2,10,12,5,1,0,3,1,19
261,Kyle Lowry\lowryky01,PG,34,TOR,10,10,363,59,140,.421,30,81,.370,29,59,.492,.529,39,45,.867,9,51,60,72,12,0,32,35,187
262,Timothé Luwawu-Cabarrot\luwawti01,SF,25,BRK,13,4,268,42,97,.433,23,63,.365,19,34,.559,.552,12,15,.800,6,23,29,16,7,2,11,26,119
263,Trey Lyles\lylestr01,PF,25,SAS,6,2,83,6,16,.375,2,7,.286,4,9,.444,.438,2,5,.400,5,21,26,3,0,0,0,3,16
264,Thon Maker\makerth01,C,23,CLE,8,0,76,10,18,.556,0,2,.000,10,16,.625,.556,10,11,.909,8,10,18,4,2,4,3,7,30
265,Théo Maledon\maledth01,PG,19,OKC,12,0,240,29,77,.377,13,43,.302,16,34,.471,.461,5,11,.455,3,22,25,34,7,0,23,23,76
266,Karim Mané\maneka01,PG,20,ORL,6,0,56,1,9,.111,1,2,.500,0,7,.000,.167,4,4,1.000,0,10,10,1,0,1,3,3,7
267,Terance Mann\mannte01,SG,24,LAC,11,0,109,12,29,.414,2,6,.333,10,23,.435,.448,1,4,.250,8,18,26,6,3,2,7,12,27
268,Nico Mannion\mannini01,PG,19,GSW,1,0,8,0,2,.000,0,1,.000,0,1,.000,.000,0,0,,0,2,2,2,0,0,0,1,0
269,Boban Marjanović\marjabo01,C,32,DAL,8,0,65,18,32,.563,0,2,.000,18,30,.600,.563,4,6,.667,12,12,24,0,0,0,1,6,40
270,Lauri Markkanen\markkla01,PF,23,CHI,5,5,141,27,58,.466,14,32,.438,13,26,.500,.586,17,21,.810,5,28,33,5,4,3,9,11,85
271,Naji Marshall\marshna01,SF,23,NOP,1,0,3,0,0,,0,0,,0,0,,,0,0,,0,1,1,1,0,0,0,0,0
272,Caleb Martin\martica02,SF,25,CHO,12,1,191,32,68,.471,8,29,.276,24,39,.615,.529,9,15,.600,9,23,32,19,12,3,10,9,81
273,Cody Martin\martico01,SF,25,CHO,11,0,125,15,28,.536,2,10,.200,13,18,.722,.571,6,8,.750,8,17,25,14,5,0,6,6,38
274,Kelan Martin\martike03,SF,25,IND,5,0,26,3,12,.250,1,5,.200,2,7,.286,.292,0,0,,1,5,6,0,2,0,2,4,7
275,Kenyon Martin Jr.\martike04,SF,20,HOU,4,0,29,6,13,.462,1,2,.500,5,11,.455,.500,0,1,.000,3,5,8,4,1,1,1,2,13
276,Garrison Mathews\mathega01,SG,24,WAS,5,0,64,12,27,.444,8,17,.471,4,10,.400,.593,8,9,.889,4,4,8,5,4,1,1,9,40
277,Dakota Mathias\mathida01,SG,25,PHI,8,2,123,19,48,.396,8,26,.308,11,22,.500,.479,2,6,.333,1,6,7,13,1,3,1,7,48
278,Wesley Matthews\matthwe02,SG,34,LAL,11,1,235,21,47,.447,16,41,.390,5,6,.833,.617,3,4,.750,4,10,14,12,4,4,1,16,61
279,Tyrese Maxey\maxeyty01,SG,20,PHI,13,4,278,66,136,.485,10,32,.313,56,104,.538,.522,5,7,.714,4,28,32,33,9,3,12,19,147
280,Skylar Mays\mayssk01,SG,23,ATL,3,0,11,0,3,.000,0,1,.000,0,2,.000,.000,0,0,,0,0,0,1,0,0,0,1,0
281,CJ McCollum\mccolcj01,SG,29,POR,12,12,421,117,249,.470,59,136,.434,58,113,.513,.588,38,45,.844,7,44,51,64,17,3,13,27,331
282,T.J. McConnell\mccontj01,PG,28,IND,9,0,157,16,29,.552,0,2,.000,16,27,.593,.552,1,2,.500,5,23,28,43,15,0,13,13,33
283,Jaden McDaniels\mcdanja02,PF,20,MIN,5,0,37,6,11,.545,4,8,.500,2,3,.667,.727,1,2,.500,2,6,8,4,2,1,3,5,17
284,Jalen McDaniels\mcdanja01,SF,23,CHO,9,0,83,13,25,.520,2,6,.333,11,19,.579,.560,7,11,.636,3,16,19,5,2,0,8,13,35
285,Doug McDermott\mcderdo01,PF,29,IND,12,0,283,51,105,.486,20,56,.357,31,49,.633,.581,19,24,.792,9,34,43,13,3,0,10,23,141
286,Sean McDermott\mcderse01,SF,24,MEM,3,0,42,2,7,.286,1,5,.200,1,2,.500,.357,2,2,1.000,2,1,3,3,0,0,3,1,7
287,JaVale McGee\mcgeeja01,C,33,CLE,13,1,220,41,93,.441,4,11,.364,37,82,.451,.462,18,30,.600,27,54,81,17,8,14,15,35,104
288,Rodney McGruder\mcgruro01,SG,29,DET,2,0,12,1,1,1.000,0,0,,1,1,1.000,1.000,1,1,1.000,1,0,1,0,0,0,0,1,3
289,Alfonzo McKinnie\mckinal01,SF,28,LAL,9,0,30,8,12,.667,3,4,.750,5,8,.625,.792,2,2,1.000,3,4,7,0,0,0,1,1,21
290,Jordan McLaughlin\mclaujo01,PG,24,MIN,4,0,64,7,17,.412,2,7,.286,5,10,.500,.471,0,0,,1,6,7,14,2,1,3,1,16
291,Ben McLemore\mclembe01,SG,27,HOU,4,1,70,12,27,.444,11,22,.500,1,5,.200,.648,0,0,,0,10,10,8,2,0,8,6,35
292,Nicolò Melli\mellini01,PF,30,NOP,8,0,101,4,20,.200,3,16,.188,1,4,.250,.275,3,4,.750,2,18,20,9,4,1,4,9,14
293,De'Anthony Melton\meltode01,PG,22,MEM,6,0,126,23,48,.479,6,15,.400,17,33,.515,.542,1,2,.500,1,14,15,16,8,6,9,11,53
294,Sam Merrill\merrisa01,SG,24,MIL,7,0,43,4,8,.500,4,6,.667,0,2,.000,.750,2,2,1.000,3,6,9,10,1,0,3,3,14
295,Chimezie Metu\metuch01,C,23,SAC,4,0,32,9,19,.474,1,3,.333,8,16,.500,.500,6,9,.667,7,4,11,4,1,2,1,4,25
296,Khris Middleton\middlkh01,SF,29,MIL,13,13,420,106,200,.530,36,77,.468,70,123,.569,.620,36,38,.947,13,71,84,74,11,3,32,33,284
297,Darius Miller\milleda01,SF,30,OKC,2,0,7,1,3,.333,1,3,.333,0,0,,.500,0,0,,0,0,0,0,0,0,1,1,3
298,Patty Mills\millspa02,PG,32,SAS,12,0,308,61,131,.466,36,81,.444,25,50,.500,.603,16,17,.941,2,17,19,39,3,1,9,20,174
299,Paul Millsap\millspa01,PF,35,DEN,12,12,287,46,88,.523,18,40,.450,28,48,.583,.625,21,29,.724,13,37,50,18,10,3,16,24,131
300,Shake Milton\miltosh01,SG,24,PHI,10,1,261,55,111,.495,14,44,.318,41,67,.612,.559,34,40,.850,2,15,17,37,11,3,14,21,158
301,Donovan Mitchell\mitchdo01,SG,24,UTA,12,12,398,101,238,.424,43,108,.398,58,130,.446,.515,38,48,.792,10,32,42,58,10,4,36,19,283
302,Adam Mokoka\mokokad01,SG,22,CHI,5,0,39,5,14,.357,1,8,.125,4,6,.667,.393,0,0,,1,3,4,4,2,1,2,5,11
303,Malik Monk\monkma01,SG,22,CHO,3,0,34,3,8,.375,3,7,.429,0,1,.000,.563,2,4,.500,1,2,3,6,0,0,1,3,11
304,E'Twaun Moore\mooreet01,SG,31,PHO,2,0,9,1,4,.250,0,1,.000,1,3,.333,.250,0,0,,1,0,1,0,0,0,2,2,2
305,Ja Morant\moranja01,PG,21,MEM,3,3,81,30,55,.545,3,9,.333,27,46,.587,.573,16,19,.842,2,5,7,19,2,2,7,6,79
306,Juwan Morgan\morgaju01,PF,23,UTA,3,0,10,0,1,.000,0,1,.000,0,0,,.000,0,0,,0,3,3,0,0,0,0,1,0
307,Marcus Morris\morrima03,PF,31,LAC,5,0,103,18,44,.409,11,23,.478,7,21,.333,.534,4,4,1.000,4,10,14,4,1,0,7,8,51
308,Markieff Morris\morrima02,PF,31,LAL,14,1,217,24,59,.407,13,40,.325,11,19,.579,.517,4,6,.667,9,47,56,13,1,6,6,22,65
309,Monte Morris\morrimo01,PG,25,DEN,12,1,317,52,100,.520,15,42,.357,37,58,.638,.595,17,25,.680,3,23,26,38,12,4,5,11,136
310,Mychal Mulder\muldemy01,PG,26,GSW,12,0,124,16,33,.485,13,29,.448,3,4,.750,.682,4,7,.571,0,12,12,6,2,1,4,10,49
311,Dejounte Murray\murrade01,PG,24,SAS,12,12,394,77,174,.443,12,39,.308,65,135,.481,.477,22,27,.815,11,74,85,65,17,1,24,25,188
312,Jamal Murray\murraja01,PG,23,DEN,11,11,388,78,169,.462,25,70,.357,53,99,.535,.536,33,44,.750,9,29,38,44,11,1,23,27,214
313,Mike Muscala\muscami01,C,29,OKC,11,0,204,35,80,.438,22,58,.379,13,22,.591,.575,11,12,.917,4,34,38,8,2,5,6,17,103
314,Sviatoslav Mykhailiuk\mykhasv01,SF,23,DET,11,0,192,31,83,.373,20,65,.308,11,18,.611,.494,15,16,.938,1,16,17,12,8,3,4,8,97
315,Abdel Nader\naderab01,SF,27,PHO,1,0,3,0,0,,0,0,,0,0,,,2,2,1.000,0,1,1,1,0,0,0,0,2
316,Larry Nance Jr.\nancela02,PF,28,CLE,13,12,462,53,107,.495,21,49,.429,32,58,.552,.593,9,16,.563,19,60,79,49,31,7,26,26,136
317,Aaron Nesmith\nesmiaa01,SF,21,BOS,4,0,57,5,19,.263,3,14,.214,2,5,.400,.342,0,0,,1,4,5,3,0,2,3,10,13
318,Raul Neto\netora01,PG,28,WAS,11,4,186,39,74,.527,14,33,.424,25,41,.610,.622,6,9,.667,3,11,14,18,11,0,9,16,98
319,Georges Niang\niangge01,PF,27,UTA,12,0,123,15,38,.395,7,26,.269,8,12,.667,.487,0,0,,2,23,25,5,1,0,6,10,37
320,Zeke Nnaji\nnajize01,PF,20,DEN,5,0,11,1,4,.250,0,2,.000,1,2,.500,.250,0,0,,1,1,2,0,0,0,0,1,2
321,Nerlens Noel\noelne01,C,26,NYK,11,0,161,15,27,.556,0,0,,15,27,.556,.556,3,5,.600,15,32,47,4,9,18,15,21,33
322,Jaylen Nowell\nowelja01,SG,21,MIN,1,0,8,1,3,.333,0,1,.000,1,2,.500,.333,0,0,,1,0,1,1,0,0,0,0,2
323,Frank Ntilikina\ntilila01,PG,22,NYK,4,0,42,6,14,.429,5,9,.556,1,5,.200,.607,1,3,.333,1,3,4,3,3,0,2,7,18
324,Kendrick Nunn\nunnke01,PG,25,MIA,5,0,61,11,29,.379,1,9,.111,10,20,.500,.397,3,3,1.000,1,4,5,9,2,1,3,2,26
325,Jusuf Nurkić\nurkiju01,C,26,POR,12,12,280,50,103,.485,3,12,.250,47,91,.516,.500,15,27,.556,23,69,92,33,11,11,23,33,118
326,David Nwaba\nwabada01,SF,28,HOU,9,7,216,28,63,.444,5,23,.217,23,40,.575,.484,9,18,.500,4,18,22,4,8,7,4,15,70
327,Jordan Nwora\nworajo01,SF,22,MIL,8,0,71,16,32,.500,7,14,.500,9,18,.500,.609,9,10,.900,1,14,15,0,4,1,8,9,48
328,Royce O'Neale\onealro01,SF,27,UTA,12,12,379,30,60,.500,22,47,.468,8,13,.615,.683,5,8,.625,16,73,89,28,9,5,13,29,87
329,Semi Ojeleye\ojelese01,PF,26,BOS,10,1,177,25,54,.463,14,33,.424,11,21,.524,.593,8,13,.615,8,27,35,6,0,0,5,13,72
330,Jahlil Okafor\okafoja01,C,25,DET,8,0,84,19,28,.679,0,0,,19,28,.679,.679,0,0,,11,12,23,2,2,1,4,8,38
331,Chuma Okeke\okekech01,PF,22,ORL,5,0,91,5,14,.357,2,7,.286,3,7,.429,.429,3,6,.500,5,8,13,8,3,1,3,2,15
332,Josh Okogie\okogijo01,SG,22,MIN,5,4,122,14,28,.500,1,8,.125,13,20,.650,.518,4,6,.667,5,12,17,9,0,5,4,13,33
333,Onyeka Okongwu\okongon01,C,20,ATL,1,0,14,2,6,.333,0,0,,2,6,.333,.333,0,0,,3,2,5,2,1,0,2,1,4
334,Isaac Okoro\okorois01,SG,20,CLE,8,8,293,26,64,.406,7,23,.304,19,41,.463,.461,10,16,.625,6,11,17,18,9,4,14,19,69
335,KZ Okpala\okpalkz01,PF,21,MIA,4,0,41,2,8,.250,0,4,.000,2,4,.500,.250,1,4,.250,3,5,8,1,2,0,1,3,5
336,Victor Oladipo\oladivi01,SG,28,IND,9,9,300,64,152,.421,25,69,.362,39,83,.470,.503,27,37,.730,1,50,51,38,15,2,18,23,180
337,Kelly Olynyk\olynyke01,C,29,MIA,9,5,267,40,87,.460,23,62,.371,17,25,.680,.592,5,8,.625,8,44,52,23,10,7,14,23,108
338,Miye Oni\onimi01,SG,23,UTA,7,0,64,5,15,.333,5,12,.417,0,3,.000,.500,0,0,,2,8,10,5,0,4,1,9,15
339,Cedi Osman\osmande01,SF,25,CLE,13,7,393,62,167,.371,30,92,.326,32,75,.427,.461,16,23,.696,8,41,49,48,13,3,21,34,170
340,Daniel Oturu\oturuda01,C,21,LAC,6,0,30,6,10,.600,0,1,.000,6,9,.667,.600,2,2,1.000,3,8,11,3,0,2,1,3,14
341,Kelly Oubre Jr.\oubreke01,SF,25,GSW,12,12,326,50,143,.350,13,66,.197,37,77,.481,.395,20,25,.800,17,49,66,12,14,11,21,26,133
342,Eric Paschall\pascher01,PF,24,GSW,11,2,214,47,92,.511,8,20,.400,39,72,.542,.554,27,33,.818,10,27,37,13,3,2,4,20,129
343,Anžejs Pasečņiks\pasecan01,C,25,WAS,1,0,6,0,1,.000,0,1,.000,0,0,,.000,0,0,,1,0,1,1,0,0,5,2,0
344,Patrick Patterson\pattepa01,PF,31,LAC,5,0,57,5,14,.357,3,10,.300,2,4,.500,.464,2,2,1.000,3,7,10,3,2,0,3,7,15
345,Chris Paul\paulch01,PG,35,PHO,11,11,348,53,122,.434,8,28,.286,45,94,.479,.467,32,33,.970,7,44,51,96,8,3,18,33,146
346,Cameron Payne\payneca01,PG,26,PHO,9,0,160,28,56,.500,9,21,.429,19,35,.543,.580,4,4,1.000,2,20,22,39,6,1,12,20,69
347,Elfrid Payton\paytoel01,PG,26,NYK,13,13,380,74,165,.448,9,28,.321,65,137,.474,.476,19,29,.655,18,38,56,54,7,2,31,28,176
348,Reggie Perry\perryre01,PF,20,BRK,5,0,42,8,16,.500,1,5,.200,7,11,.636,.531,1,3,.333,3,10,13,4,0,0,3,4,18
349,Theo Pinson\pinsoth01,SG,25,NYK,5,0,12,0,4,.000,0,4,.000,0,0,,.000,0,0,,0,1,1,0,0,0,0,0,0
350,Mason Plumlee\plumlma01,C,30,DET,11,11,295,32,64,.500,0,4,.000,32,60,.533,.500,21,27,.778,36,68,104,40,17,6,17,37,85
351,Jakob Poeltl\poeltja01,C,25,SAS,12,3,225,23,45,.511,0,0,,23,45,.511,.511,3,15,.200,30,40,70,24,6,7,11,21,49
352,Vincent Poirier\poirivi01,C,27,PHI,3,0,14,1,3,.333,0,0,,1,3,.333,.333,2,4,.500,2,1,3,1,0,1,1,1,4
353,Aleksej Pokusevski\pokusal01,PF,19,OKC,10,0,161,14,52,.269,6,31,.194,8,21,.381,.327,0,0,,5,35,40,11,5,11,14,10,34
354,Jordan Poole\poolejo01,SG,21,GSW,7,0,72,12,29,.414,5,17,.294,7,12,.583,.500,9,9,1.000,1,7,8,6,1,0,4,7,38
355,Michael Porter Jr.\portemi01,SF,22,DEN,4,4,117,30,53,.566,11,26,.423,19,27,.704,.670,7,8,.875,5,22,27,7,4,6,2,11,78
356,Otto Porter\porteot01,SF,27,CHI,11,6,260,45,103,.437,22,52,.423,23,51,.451,.544,24,27,.889,14,57,71,21,8,1,12,18,136
357,Bobby Portis\portibo01,C,25,MIL,13,1,306,62,113,.549,12,28,.429,50,85,.588,.602,13,18,.722,30,76,106,15,12,6,15,27,149
358,Kristaps Porziņģis\porzikr01,C,25,DAL,2,2,50,12,35,.343,6,16,.375,6,19,.316,.429,1,2,.500,2,12,14,1,0,4,4,4,31
359,Dwight Powell\poweldw01,C,29,DAL,9,6,178,14,30,.467,1,5,.200,13,25,.520,.483,16,22,.727,10,22,32,11,11,5,8,23,45
360,Norman Powell\powelno01,SG,27,TOR,11,3,249,36,97,.371,19,50,.380,17,47,.362,.469,25,29,.862,1,22,23,7,12,2,13,19,116
361,Taurean Prince\princta02,PF,26,BRK,12,4,218,30,74,.405,13,37,.351,17,37,.459,.493,24,27,.889,2,32,34,7,8,8,11,21,97
362,Payton Pritchard\pritcpa01,SG,23,BOS,11,0,254,39,77,.506,15,34,.441,24,43,.558,.604,9,10,.900,5,23,28,34,13,4,19,22,102
363,Immanuel Quickley\quickim01,PG,21,NYK,9,0,161,26,70,.371,10,31,.323,16,39,.410,.443,20,21,.952,1,16,17,19,6,3,7,17,82
364,Jahmi'us Ramsey\ramseja01,SG,19,SAC,4,0,16,2,4,.500,1,3,.333,1,1,1.000,.625,0,0,,0,4,4,1,0,1,1,0,5
365,Julius Randle\randlju01,PF,26,NYK,13,13,487,111,221,.502,18,51,.353,93,170,.547,.543,61,78,.782,18,118,136,87,8,3,51,45,301
366,Cam Reddish\reddica01,SF,21,ATL,11,10,313,45,119,.378,19,57,.333,26,62,.419,.458,25,30,.833,9,42,51,12,15,2,18,28,134
367,J.J. Redick\redicjj01,SG,36,NOP,11,0,243,28,85,.329,18,61,.295,10,24,.417,.435,16,16,1.000,2,22,24,12,3,0,9,18,90
368,Paul Reed\reedpa01,PF,21,PHI,4,0,51,8,19,.421,0,3,.000,8,16,.500,.421,0,0,,7,3,10,3,1,4,5,4,16
369,Naz Reid\reidna01,C,21,MIN,11,3,215,44,81,.543,11,29,.379,33,52,.635,.611,20,28,.714,11,36,47,13,4,11,15,33,119
370,Nick Richards\richani01,PF,23,CHO,4,0,12,2,2,1.000,0,0,,2,2,1.000,1.000,1,2,.500,1,3,4,0,0,0,0,2,5
371,Josh Richardson\richajo01,SG,27,DAL,8,8,260,39,95,.411,16,50,.320,23,45,.511,.495,16,17,.941,9,14,23,13,7,2,10,30,110
372,Austin Rivers\riverau01,SG,28,NYK,9,2,247,37,81,.457,20,49,.408,17,32,.531,.580,0,0,,3,22,25,24,5,0,13,16,94
373,Duncan Robinson\robindu01,SF,26,MIA,10,10,322,44,100,.440,35,86,.407,9,14,.643,.615,15,19,.789,0,40,40,14,7,3,16,19,138
374,Glenn Robinson III\robingl02,SF,27,SAC,10,0,191,24,48,.500,9,21,.429,15,27,.556,.594,13,14,.929,4,18,22,11,0,1,5,9,70
375,Jerome Robinson\robinje01,SG,23,WAS,6,1,90,9,23,.391,4,10,.400,5,13,.385,.478,5,5,1.000,0,10,10,8,3,0,4,13,27
376,Mitchell Robinson\robinmi01,C,22,NYK,13,13,392,52,80,.650,0,0,,52,80,.650,.650,9,19,.474,49,58,107,7,20,24,10,34,113
377,Isaiah Roby\robyis01,PF,22,OKC,9,3,168,32,54,.593,6,15,.400,26,39,.667,.648,10,18,.556,12,29,41,10,1,4,9,22,80
378,Rajon Rondo\rondora01,PG,34,ATL,3,0,50,5,14,.357,2,6,.333,3,8,.375,.429,0,0,,1,1,2,16,1,1,5,2,12
379,Derrick Rose\rosede01,PG,32,DET,8,0,189,41,102,.402,6,21,.286,35,81,.432,.431,23,28,.821,3,13,16,43,8,3,19,11,111
380,Terrence Ross\rosste01,SG,29,ORL,11,0,298,59,137,.431,22,58,.379,37,79,.468,.511,31,34,.912,3,26,29,16,14,2,19,20,171
381,Terry Rozier\roziete01,SG,26,CHO,13,13,426,90,188,.479,41,94,.436,49,94,.521,.588,34,44,.773,6,42,48,36,19,7,24,28,255
382,Ricky Rubio\rubiori01,PG,30,MIN,11,3,269,24,63,.381,5,21,.238,19,42,.452,.421,16,17,.941,4,27,31,59,15,0,18,24,69
383,D'Angelo Russell\russeda01,PG,24,MIN,11,10,346,85,195,.436,31,80,.388,54,115,.470,.515,27,39,.692,6,29,35,60,14,4,38,25,228
384,Domantas Sabonis\sabondo01,PF,24,IND,12,12,453,105,189,.556,9,26,.346,96,163,.589,.579,44,64,.688,38,115,153,69,8,6,43,45,263
385,Luka Šamanić\samanlu01,PF,21,SAS,3,0,8,1,5,.200,1,2,.500,0,3,.000,.300,1,2,.500,0,0,0,0,0,0,0,0,4
386,JaKarr Sampson\sampsja02,PF,27,IND,7,0,52,7,15,.467,0,2,.000,7,13,.538,.467,4,5,.800,3,12,15,0,1,2,1,6,18
387,Dario Šarić\saricda01,PF,26,PHO,7,0,132,26,58,.448,10,28,.357,16,30,.533,.534,12,13,.923,3,29,32,7,4,1,11,14,74
388,Tomáš Satoranský\satorto01,SG,29,CHI,3,0,68,7,15,.467,2,6,.333,5,9,.556,.533,3,3,1.000,2,5,7,18,4,1,8,2,19
389,Dennis Schröder\schrode01,SG,27,LAL,14,14,432,74,177,.418,17,50,.340,57,127,.449,.466,32,41,.780,9,49,58,67,14,3,33,39,197
390,Mike Scott\scottmi01,PF,32,PHI,8,2,153,14,44,.318,9,36,.250,5,8,.625,.420,2,3,.667,4,18,22,1,2,2,3,10,39
391,Collin Sexton\sextoco01,SG,22,CLE,8,8,299,78,147,.531,16,31,.516,62,116,.534,.585,29,35,.829,4,13,17,28,11,2,17,23,201
392,Landry Shamet\shamela01,SG,23,BRK,13,0,231,21,63,.333,14,47,.298,7,16,.438,.444,14,16,.875,2,18,20,16,9,1,11,15,70
393,Pascal Siakam\siakapa01,PF,26,TOR,10,10,360,75,164,.457,15,48,.313,60,116,.517,.503,34,45,.756,25,61,86,50,10,6,25,41,199
394,Chris Silva\silvach01,PF,24,MIA,5,0,48,5,8,.625,0,0,,5,8,.625,.625,10,12,.833,7,10,17,6,1,2,8,14,20
395,Ben Simmons\simmobe01,PG,24,PHI,11,11,360,52,101,.515,1,3,.333,51,98,.520,.520,31,50,.620,10,85,95,87,18,11,43,38,136
396,Anfernee Simons\simonan01,SG,21,POR,9,0,92,13,41,.317,10,31,.323,3,10,.300,.439,4,6,.667,0,15,15,5,1,2,3,10,40
397,Deividas Sirvydis\sirvyde01,SG,20,DET,1,0,1,0,0,,0,0,,0,0,,,0,0,,0,0,0,0,0,0,0,0,0
398,Marcus Smart\smartma01,PG,26,BOS,10,10,328,36,101,.356,21,57,.368,15,44,.341,.460,31,40,.775,6,21,27,60,15,6,17,25,124
399,Dennis Smith Jr.\smithde03,PG,23,NYK,2,0,24,2,8,.250,0,3,.000,2,5,.400,.250,4,4,1.000,0,2,2,3,3,0,1,4,8
400,Ish Smith\smithis01,PG,32,WAS,11,0,212,28,71,.394,4,12,.333,24,59,.407,.423,5,13,.385,6,31,37,44,7,3,11,12,65
401,Jalen Smith\smithja04,PF,20,PHO,2,0,20,2,5,.400,0,1,.000,2,4,.500,.400,0,2,.000,3,2,5,1,0,1,1,1,4
402,Tony Snell\snellto01,SG,29,ATL,2,0,16,1,6,.167,1,4,.250,0,2,.000,.250,0,0,,0,1,1,0,0,0,0,3,3
403,Cassius Stanley\stanlca01,SG,21,IND,5,0,12,2,3,.667,1,1,1.000,1,2,.500,.833,4,5,.800,1,1,2,0,0,0,1,2,9
404,Lamar Stevens\stevela01,PF,23,CLE,9,0,128,15,37,.405,1,7,.143,14,30,.467,.419,8,10,.800,3,17,20,7,4,0,3,6,39
405,Isaiah Stewart\stewais01,C,19,DET,9,0,152,17,37,.459,0,1,.000,17,36,.472,.459,4,7,.571,26,20,46,6,3,6,5,22,38
406,Max Strus\strusma01,SF,24,MIA,3,0,64,10,20,.500,5,15,.333,5,5,1.000,.625,1,3,.333,1,7,8,3,1,0,0,4,26
407,Edmond Sumner\sumneed01,SG,25,IND,5,2,70,14,25,.560,2,9,.222,12,16,.750,.600,1,3,.333,4,6,10,4,4,0,4,4,31
408,Jae'Sean Tate\tateja01,SF,25,HOU,10,1,246,34,63,.540,4,15,.267,30,48,.625,.571,12,18,.667,14,28,42,21,8,5,12,27,84
409,Jayson Tatum\tatumja01,SF,22,BOS,10,10,346,101,213,.474,35,80,.438,66,133,.496,.556,32,36,.889,4,67,71,38,10,8,24,18,269
410,Jeff Teague\teaguje01,PG,32,BOS,9,2,180,23,64,.359,9,17,.529,14,47,.298,.430,18,21,.857,4,18,22,23,14,2,9,13,73
411,Garrett Temple\templga01,SG,34,CHI,11,1,286,33,70,.471,20,47,.426,13,23,.565,.614,9,11,.818,6,22,28,20,10,2,13,30,95
412,Tyrell Terry\terryty01,PG,20,DAL,6,0,20,2,6,.333,0,3,.000,2,3,.667,.333,0,1,.000,0,3,3,4,2,0,1,1,4
413,Daniel Theis\theisda01,C,28,BOS,11,10,246,37,65,.569,5,21,.238,32,44,.727,.608,3,9,.333,14,41,55,14,4,10,11,25,82
414,Brodric Thomas\thomabr01,SG,24,HOU,3,0,19,1,5,.200,0,4,.000,1,1,1.000,.200,3,5,.600,1,2,3,4,0,0,3,5,5
415,Matt Thomas\thomama02,SG,26,TOR,4,0,49,8,18,.444,7,13,.538,1,5,.200,.639,1,1,1.000,0,5,5,5,2,0,1,2,24
416,Tristan Thompson\thomptr01,PF,29,BOS,9,9,205,29,56,.518,0,0,,29,56,.518,.518,13,20,.650,26,53,79,7,3,7,12,24,71
417,Sindarius Thornwell\thornsi01,SG,26,NOP,3,1,29,1,5,.200,0,1,.000,1,4,.250,.200,0,0,,0,2,2,0,4,0,0,2,2
418,Matisse Thybulle\thybuma01,SG,23,PHI,10,0,130,9,29,.310,5,20,.250,4,9,.444,.397,3,5,.600,1,9,10,8,11,6,4,13,26
419,Xavier Tillman Sr.\tillmxa01,PF,22,MEM,6,0,109,20,36,.556,0,3,.000,20,33,.606,.556,2,2,1.000,7,14,21,10,5,4,1,10,42
420,Obi Toppin\toppiob01,PF,22,NYK,3,0,34,3,14,.214,3,8,.375,0,6,.000,.321,2,2,1.000,1,6,7,3,1,2,1,1,11
421,Juan Toscano-Anderson\toscaju01,SG,27,GSW,6,2,90,7,9,.778,2,4,.500,5,5,1.000,.889,3,5,.600,1,19,20,11,2,4,5,10,19
422,Karl-Anthony Towns\townska01,C,25,MIN,4,4,132,29,63,.460,6,16,.375,23,47,.489,.508,24,25,.960,16,34,50,17,2,11,10,11,88
423,Gary Trent Jr.\trentga02,SG,22,POR,10,0,242,39,88,.443,23,53,.434,16,35,.457,.574,8,12,.667,2,13,15,12,4,1,4,15,109
424,P.J. Tucker\tuckepj01,PF,35,HOU,10,10,319,20,38,.526,15,27,.556,5,11,.455,.724,5,7,.714,8,38,46,14,12,8,13,33,60
425,Myles Turner\turnemy01,C,24,IND,12,12,380,55,117,.470,15,53,.283,40,64,.625,.534,24,32,.750,17,65,82,13,18,50,16,41,149
426,Jonas Valančiūnas\valanjo01,C,28,MEM,11,11,301,64,120,.533,4,13,.308,60,107,.561,.550,32,42,.762,31,87,118,20,9,11,26,39,164
427,Denzel Valentine\valende01,SG,27,CHI,9,0,165,24,55,.436,13,33,.394,11,22,.500,.555,2,2,1.000,2,36,38,16,10,1,6,8,63
428,Jarred Vanderbilt\vandeja01,PF,21,MIN,9,0,134,19,29,.655,0,0,,19,29,.655,.655,9,19,.474,12,34,46,12,10,4,6,15,47
429,Fred VanVleet\vanvlfr01,SG,26,TOR,11,11,394,84,193,.435,40,105,.381,44,88,.500,.539,18,22,.818,10,36,46,66,13,6,20,21,226
430,Devin Vassell\vassede01,SG,20,SAS,11,0,179,17,46,.370,9,22,.409,8,24,.333,.467,6,6,1.000,5,29,34,13,13,3,3,12,49
431,Gabe Vincent\vincega01,PG,24,MIA,3,2,86,17,43,.395,10,28,.357,7,15,.467,.512,8,10,.800,0,6,6,13,2,0,7,10,52
432,Nikola Vučević\vucevni01,C,30,ORL,12,12,372,106,212,.500,29,70,.414,77,142,.542,.568,22,28,.786,27,103,130,42,13,5,14,15,263
433,Dean Wade\wadede01,PF,24,CLE,12,0,138,11,30,.367,7,20,.350,4,10,.400,.483,2,2,1.000,4,14,18,7,5,1,5,11,31
434,Moritz Wagner\wagnemo01,C,23,WAS,5,0,68,11,17,.647,4,7,.571,7,10,.700,.765,6,8,.750,2,18,20,4,1,0,1,18,32
435,Lonnie Walker\walkelo01,SG,22,SAS,12,12,348,63,145,.434,25,59,.424,38,86,.442,.521,20,26,.769,5,32,37,22,7,7,12,24,171
436,John Wall\walljo01,PG,30,HOU,7,7,237,49,108,.454,10,31,.323,39,77,.506,.500,22,26,.846,5,28,33,36,9,7,24,9,130
437,Brad Wanamaker\wanambr01,PG,31,GSW,12,0,189,15,47,.319,6,18,.333,9,29,.310,.383,19,22,.864,3,20,23,33,10,2,9,19,55
438,T.J. Warren\warretj01,SF,27,IND,4,4,117,27,51,.529,0,7,.000,27,44,.614,.529,8,10,.800,2,12,14,5,2,0,4,16,62
439,P.J. Washington\washipj01,PF,22,CHO,13,13,371,57,135,.422,16,44,.364,41,91,.451,.481,37,50,.740,24,64,88,37,13,18,26,42,167
440,Yuta Watanabe\watanyu01,SF,26,TOR,6,0,73,5,17,.294,4,9,.444,1,8,.125,.412,0,0,,4,17,21,2,2,6,3,7,14
441,Tremont Waters\watertr01,PG,23,BOS,4,1,42,3,11,.273,2,5,.400,1,6,.167,.364,4,4,1.000,1,1,2,13,2,0,9,4,12
442,Paul Watson\watsopa01,SF,26,TOR,3,0,8,1,2,.500,0,1,.000,1,1,1.000,.500,0,0,,1,2,3,0,0,1,0,1,2
443,Russell Westbrook\westbru01,PG,32,WAS,7,7,260,51,135,.378,10,33,.303,41,102,.402,.415,23,35,.657,7,61,68,79,9,2,37,23,135
444,Coby White\whiteco01,PG,20,CHI,12,12,427,77,184,.418,31,85,.365,46,99,.465,.503,27,32,.844,7,59,66,75,3,1,37,31,212
445,Derrick White\whitede01,SG,26,SAS,1,0,23,3,9,.333,1,4,.250,2,5,.400,.389,2,2,1.000,0,1,1,1,0,2,2,1,9
446,Hassan Whiteside\whiteha01,C,31,SAC,9,0,114,23,44,.523,0,0,,23,44,.523,.523,12,24,.500,9,29,38,5,2,10,7,13,58
447,Andrew Wiggins\wiggian01,PF,25,GSW,12,12,393,79,183,.432,24,65,.369,55,118,.466,.497,31,42,.738,11,45,56,30,5,21,24,28,213
448,Grant Williams\willigr01,PF,22,BOS,9,1,176,19,43,.442,7,18,.389,12,25,.480,.523,2,5,.400,12,19,31,6,5,5,7,26,47
449,Kenrich Williams\willike04,PF,26,OKC,12,0,145,16,33,.485,4,10,.400,12,23,.522,.545,7,8,.875,8,19,27,13,6,4,6,18,43
450,Lou Williams\willilo02,PG,34,LAC,12,0,236,41,94,.436,10,26,.385,31,68,.456,.489,20,25,.800,3,20,23,31,8,1,10,11,112
451,Patrick Williams\willipa01,PF,19,CHI,12,12,327,47,96,.490,13,27,.481,34,69,.493,.557,20,23,.870,10,35,45,13,11,10,21,31,127
452,Robert Williams\williro04,C,23,BOS,8,0,131,24,31,.774,0,1,.000,24,30,.800,.774,6,7,.857,20,32,52,5,9,12,11,10,54
453,Zion Williamson\willizi01,PF,20,NOP,10,10,320,87,159,.547,0,2,.000,87,157,.554,.547,44,72,.611,36,49,85,16,12,5,29,23,218
454,D.J. Wilson\wilsodj01,PF,24,MIL,7,0,71,11,26,.423,7,16,.438,4,10,.400,.558,1,2,.500,3,16,19,3,1,2,4,9,30
455,Dylan Windler\windldy01,SF,24,CLE,1,0,9,1,5,.200,1,4,.250,0,1,.000,.300,0,0,,0,0,0,0,2,0,1,0,3
456,Cassius Winston\winstca01,PG,22,WAS,1,0,2,0,1,.000,0,1,.000,0,0,,.000,0,0,,0,0,0,1,0,0,0,1,0
457,James Wiseman\wisemja01,C,19,GSW,12,12,255,56,116,.483,6,15,.400,50,101,.495,.509,17,29,.586,16,59,75,5,5,19,18,40,135
458,Christian Wood\woodch01,C,25,HOU,9,9,298,84,158,.532,15,44,.341,69,114,.605,.579,25,38,.658,18,73,91,11,6,16,17,23,208
459,Robert Woodard\woodaro01,SF,21,SAC,5,0,16,6,11,.545,1,3,.333,5,8,.625,.591,0,2,.000,3,5,8,0,0,0,1,0,13
460,Delon Wright\wrighde01,SG,28,DET,11,6,289,28,74,.378,7,22,.318,21,52,.404,.426,20,23,.870,10,30,40,41,8,7,11,8,83
461,Thaddeus Young\youngth01,PF,32,CHI,8,0,191,34,59,.576,3,11,.273,31,48,.646,.602,6,9,.667,9,22,31,24,6,2,20,21,77
462,Trae Young\youngtr01,PG,22,ATL,11,11,354,73,184,.397,17,59,.288,56,125,.448,.443,89,101,.881,13,30,43,92,6,2,45,20,252
463,Cody Zeller\zelleco01,C,28,CHO,1,1,19,3,6,.500,0,2,.000,3,4,.750,.500,0,1,.000,1,2,3,0,3,1,1,1,6
464,Ivica Zubac\zubaciv01,C,23,LAC,13,0,237,35,52,.673,0,0,,35,52,.673,.673,26,33,.788,21,38,59,12,6,11,13,30,96